5 2
109 148
52 131
44 66
65 71
48 23
91 101
86 39
74 120
13 91
01110100111a1100110111110101001011101110010a11111011011011011110111111111011211211122111021211220010022210211110111111a01101110111111101111100110111111100110111
11111011111a1110111011111110111101110111011a11111010111110111110111110010110202110011120122212211210221122011011101111a10110101101011101111111111111111111110101
01111111111a1111101111110000111011111111011a10110111111001111011101010110111221021110221012122012002111220111111011110a00101101011011101101011111111110111110110
11111111100a1111010111110111110111111111111a11100011011110110111111111111101210212022110122022020201221112010110011001a10111011111011011011101111111111111111111
11110111011a0110110111100111110111101111111a10001111011111111011110110110101011010100102202002011101112020211111111101a11101111110111111111111111101111101101110
11111101111a1111001111111111011111110111111a10111111011111011111110111011111222101122021002200120222111211111110111101a11111111111011110110110011000111111011111
11110111110a1111111111011110011001011110111a11011101110111100111111111111111020010111212110122211011112222211110011111a11101101100101011111011011111110011111101
11011111011a1111011010111110111110110111111a11101011110111010111110110111111212212110221021221120210201121211111111111a00010111100011111100101111111111100110011
10111111101a1110100001111101110011111011111a11011111110101111111111010101110112101212002201111220122221201201101111111a11111111101111101111111111101101111011111
11111111011a1110111111101111001110110111111a11111101111111011111011110011011112221021011121211121111200222211111111111a11110110111011110111111101110111111101111
01110010101a1111101111110111110001111010001a11111111110111111111011101101101012121120121111211222112121212211111111111a11110110011111111111110001101011111101111
00110011111a1011111110111111101011011101110a11111101111111111111111011101111202000101002120012121002221100101101100111a11110111110110011111111101011111111111101
11101111101a1111111111111110111101111111111a01111001110011011111010110110111021002222121222021122112010211011111011110a10100100111111111111110111111111111110111
11011010110a1111101111010111011111111110111a10110111111111111111110111110111212200211222210201011022111111001111111110a11101100111110111111111111111110111101101
10000101111a1101101101011011001011111011111a00010111001110110101111111110101110022210202011110201211020122211111111101a10100011111111001101111100111111111111111
11111110111a1111011111111001111111110111011a11101011111110011010011011111101220122111102211011012101022011211111111111a10011111111010111101011111111111111111011
11111111111a1111110001111111111111111101101a10111111100101111101110011111110122122122012200002211121102110111111101111a11111011101111111011100100110100111010111
11111001111a1111011110110101110101101101111a01111111100011011111111111110110012112112221222222101101222212011110101111a00100110001111101110101110010011111111111
01111101111a1111101110000111111011001111011a11110101111111110111111111111100222121022001111210001211101102010111101100a11111011101011011110111111111011011100111
10100011111a1111110000100111110111101000111a11101111111100111101111111111011221120111122022201021221011212111000111111a11100110110111111110111111000111011111110
11111111111a1110111111101111101111011100010a11011011111111110111111110111111210011121210200011112010112221211111100110a11101101110011111111001001101011101101111
11110110101a1110101011110101111001101011110a11011111101111011010111111111110001122111212110220210211212202211111100111a01011111110111011111101111110110110111111
11011101111a0111111001111011111011010111111a11001111010111111100111101111110112020101201222020120111022110211110111111a11011111111010011111011111111110011011101
10110111111a1111011111100101011111011111111a10111111101111111110011111111110020011222210102200212212212211211111001101a11011011011111111111111111111111011111111
01001110010a1101111111111110101101111010101a10101111010011110111111111110001200020221112212101111220011112211111111110a10111111111111111111101100111011111101111
11111101110a1110111010111111101100101110111a10011111111111110111111111101011102010122022221201222212021101111111110110a11101010011110111110011111111111111001110
11110111111a1111110110101111110110111101111a11101011111111111111101111011110210201002222211221022110202101111111011101a11111001001100111111101001111111110111110
11110101011a1111110011011111110110111000110a11110101111001111010011100101110211021211121111112121110002202110111111111a11100111111110111110110111111110110111110
11011111111a0111011111011111010111111110111a11111111101010010011011111111110122211211101221220120001210111211111111111a11111111011101110011001111111101111111011
11111011111a1100111111111110110110110101111a11111112122101122011122221021002211120111111111101111111101011110111111111a11001111110101111111111101110101111111111
11110111111a0101011111101111111101110110111a11111110012210012100111102111121210122111101111111110011111111011111101111a10111100011100101111111110110111111111111
11111110111a1000111111110111111111111111011a11110111011221211221121222112021101111111111111011110111100111111111111111a11111111110111111010110111110111110111101
11100010101a1100101111111111111111101111111a10101102212011012212021001212112221100101111111010111110111111111111101110a11001101101111111111110010011111000101111
00111001022b0222101220222122222110010011101a11111111212222021222102111211101020011111011101111001111101101101101110110a11111111000111101100111111101111100111111
10110111211b1022111021202101210211211021001a11011110121111221202120021212110121011111011111101111111111111001111101111a11111001011111011111111110111101111110101
11001111122b1221222211111122211200002011111a11111111111021021112211121101121011212111111111110011110111110111111111111a11101001011111011111110111111011110111111
10101111121b2122210202112121120122201000011a11110112220012200220220211110120111110110111111110111111001111011111010011a11011011101110101111111110110111111110111
11111111221a2122210011122122102221011201111a11011100122121122221210111210220110212111101111110101110110111100111110120b20101211220021212211102011111011101111011
11011001112a0122222122111022021220212211111a10111112221120221021212120102212211101111011001110110110111110011001110022a21101202211202111102211122221101111010000
01001111111aabbbbaabaabaabbaaabb10120020111a11011101222012201122112011101122222121111111111100111100111011111010110001a10001020211222220221201011121111111111111
1111100111200121102210222221012b21200100011a10101111222021112211222102112211202120100111010101111101110111111101111102a221abaaaaaaaabbaabbbbbababbbaaaaaaaaaaaaa
1111111021011022211120210222211a12212001111a11100101122002202111010222012221222211011110101111101101110011101111001111b102a2212112110212221111221211111001111100
0100111120200122122120111221210b12200211111a11011010021122202211022111222120220011111110111110100110111011010011111101a200b2121101112011102102110221001111111111
1111011122110121111221202202220b12112120101a11111110012111212202120201111121222120011111111110101111011101111111011112a121b2221201212101020222211211011111001101
1111111021122022210121112120022a22022121111a11111112110212021212121101210122112022111011111010101111100011111011111110a212a2121111212111022112101021111111001110
1111010111202100121222221101222b01002120110a00011101202112212212222211102122122120111111110010111111011011110101100111b110a1221101012021101022102221111011111111
1110111121121120211202112000222a00102210111a11101112010212212210222211110011101122101111111101101010111000111111111120a212a1111011002210211010102111111111110101
1101111120111012002112112122222a22110001110a11011111022101101211110201010211100020001111110111011111110001101011101112b111a2221121200122112221121011111111111111
0101111112010221012112120101122b10022011101a11101102112210111210111222110102112121111101111111111111100111111111110102a221b2122220111221112002121220110101111111
0011011121002121100001112002202b01121111111a11111011110221111222121110012102210221110110111111011111010111001111110111a211a1110102110211111112120100111010111010
1011111022121012222010012112222b20001011101a00011112221022021200020221202212200202021001111111110111111011111111011122b211b2022121001112122121202100111111111001
0111110120120121222121211002211b12212121111a11110112022222212122221222222120122122110211100111011011111101110111111022b221b2201121001000021010111201110101011001
1110111101111021021202120101012b12100221110a10111010021201210212022200222002200222112210111011010101100111101111111122b022b2120112021021211111202100111110011110
1111101111222101012222112210220a11211111111a11011102100122022222222122222202121222101211111100111111101101111110001101a012a2221211012212022120121120111110101111
0111101111120121222122101201111b20012120111a10010111110002222222202212222222202020222200111100111111111011101111101110a121a0112020221012012012011221001111011111
1100011112122121212202010222211b21100211110a01100002121102202122222202222222221012221221111111111111110111011111111120a201a2212011220001201120220121111111101011
0011111002211220021201022022101a01122111111a11010111201222222211212022020221222222012121111110011011110110111101111012b101a2100220212020221210122101101111111001
0111111111021121201122111221111a11120211111a10111110221221222222222221221002122222202121111110111111011111110110001012a121a1202102122020122221110110111111111111
1111111020122021110122021221122b11121101011a00110112212220120221222020221022221102222201101100010111110011110111011111a121b1212200122201120122011120011111111011
11111111112babaababbbbaabababbba21022201111a01101102111112022212012002121220101222221011101111101111111112210211200122b022b2221122222222211210110220011010111111
11101011200a2002121022202211112112222211111a10011111111120121221220111222011022110212110110111111110111110222210101222a022b0102221202222021122122120101111110111
01110011210a2222001222011220200202110221011a11111111110112211001111112120101120221101011001110111111101112112211210101b220a2020020020221220122111011100111110011
11010011121b1122221121111112221021210221011a11110111011121122112212011222020112020102210011110111111110111202201102020b212b2222202200222110012121001101111101100
11111101121b1222122210120021012122111121011a11011011111122201212122110111222222211012111111111100101111112221221012112b121b2222001002102211121100120111111111111
11111111111a1110011101111110010111111111111a11001111100121200121201012012001202012211211111111110111101111210022111102b022b2202210012212110222020011111111111011
11101111111a1101100011110111111111110010111a11101111110022211110101012101121211120220221111111111111111101221122001122a201a0020012100022102012122011011011111111
11111100111a1111111010111101111011110111111a10111111001101211222012211002121022121021111111111111110111111212222010002b212a2112021022002220222121211011111111101
11111111111a1111011111001111111101101110101a10110111011111121111012122212212122200111201111101111111001111212002111212b122a2002222120202110021210211111111111111
00011010111a1011100111110110111111011111101a00100111101111011201221211101121010102222021010011111001111011201202111022b212a1120012212211110001111011111111111111
11110010111a0001111110110111010111111111011a11010011011112121212222021201111012122212021111101111111101110112012022021a112b1221121121210111111111111011111111100
10111111111a1111111011111111101110101011110a11011011111102201100121010101211122222112111111111111111110102100212121121a122a1211011011121111111011111111111111110
11111111101a0101111011112121111102201220021a01112021102110202221212021111111120200221211101111101111110102000121121221b211a2101221121221110111111111111011111101
10101011111a0011011100102020122201220211112a12112111102112000102221222201221111212221111111101101111011111101221121011a220a2102112122012100111101101111111101111
10001111111a0111111011111011201122122221120b12211202110111012121022210101010112221120001111001111110101110110100222112b121b2111112022100111110111111010111011101
11110011110a1010111101002122222021220021022a10100120000112012221001010110111210211022221111000111111111111212110110112a012b0201212212022111110111111111110111100
10101100100a1111011110112000221222212122211b21002102002102102220111120112210221222221201111110001111111100221122202122a221b1012001022101111111101100111111111011
11111011001a1111001001111021212122111122221a12002210211120101121122101121212220211111222121202111121001202120200222111b121a2010121221021110110111101111111011100
11001010011a0111100111001222010010102211102b01222002020122111211122101100021221021211121222011222211020021000120022022b121b2222121221101110110111111111111111111
11110110111a1111111110111101102112010121011b22121120111100222212211012122120112102220222021201122111210122222210022222b112a1221111220112111111011111011111011111
aaaaaaaaaaaa1111111011112000220211102121111aabbbabababbababaabba121120001121212112120120020222222012101011121222120001b221a2112221122122111111111111011101111111
101100111110111110101011212202201212221021112011212222212120021b202121210210221111222202012001110220202002122222222221b101a2100211112122111001110111011111111111
111101111101101111110111220221022112111112120200112220211111111a101110011111110010011122221212201222200222122111011221a111b1112221221201111111111111101111110111
110001111110011111101111220221122121200222012111011111201111111a001011101111111111111012211202110121022121222222202222b121a2212220112211111010111111011100111111
010111111111110111010111111220110211221222021200122121111111110a101111111111101101101122212121221202221221122020112201b221b2120022222210110100111111111101111111
111111111110001111100110110211201112120111221222222112111011111a101111111111101101010121221111022122001001222112022002a122b0101120122001111111111011111011111101
110111111101101111110111212200022021021011121111212210201100111a111011011111101111011101221212122121202022110010221112b011a2001121121111010111111100111110010110
111111111110111101111111200222210111221112002202022122211111011a111111101111110100111101221122222021222120121012222021b120a2111200111210111111111011001110001110
101101111111101111111011222111211121212102222222212121211111111a010011111101111101101002222222112111201100002120211221b112b2101211121022111111110111111011110111
111101111111111011111011021111201022212122112210102212100001111a111111111110111010111101001101121201121111021221010201b021b0102122211112101011111011111111111010
111111011101010010101110000122010212211112222121222102011111111a111111111111111010011112220121120111212012222221212100b111b2222201111111111101111111011010011111
110111110111111101111111211100000022102211120211121111211001111a101111110111111011010121102011222101222111221112102121a110a1111011111011111110111111010100111111
111111111110111111100110122022102220222011200221021212001001011a111111111110111111111110222200221121221221121002001211a011a1111111111101111101110111111011110011
111101101111111111111011202101110211212101111221012221111111110a111110011111101011111112020121012101122200221200212111a011a1010101100111111111111111111101101111
110111011111111111101100120012102010212122020002220122010111111a110001111111111111111121121210112011112001122122112011a101a1111110111100110011111011111101011101
111111101111101111001111022022001211010121220202121021210111111a111101011011111110110122220222101021111101211011120011a111a1011110111011111001101110010111110010
001111111111111110010101211111111011212021001212011121011111110a110111111111111111111112011012011201120212212101021211a110a1101111010011011111111111101111111111
110111111000101111110100201211022121211000122012211101201011111a111111111111011001110000002211112122121110221112120201a111a1110011111101111110111101111011111110
100111110110101111110111221211101102222210201111001212011111110a111111101111101101011011120222222212010210022210221011a111a1011111111110101100011111110111111011
111111011101111111111111202222221211122121110102012121101110111a111111111010110011111110012011220210121201121102202021a101a1110010111110111111111110101111111101
111011001111111101011111001221221211100112122101010212111100011a111101011111111111001111211211222020122211121122110121a100a1110111111101011011101110110111111011
110111101110110111110111201112102201221112220212212012201111111a111101101101100111111010212202112222212020212112111011a110a1111011111010011110101010111110111001
111101001010111011011111122221100122001210210000022221200111110a110011111111001010111121212221102201101120212222121021a111a1001011011111110111011101101101111111
111011101111110111111011101111111011010011010111111011110011111a001110111110101111110121122222211121022112112101020111a111a0011111011111011111111111100111010011
011011010111111110110111110111101111110111100111111111111011101a101110111111101111010102201011222222220112122202212001a101a1111111101110110011110111001111101110
011111111001100111110011011111111111111010111111100011110100111a101111011011111101001121111210212222111000011221112210a111a1111111111101111111111110101011111111
010111011001111111111111111111110101101111111001110111111110111a111111110011111111110011120020020022212112021222111011a111a0111111111111101111111010111011100111
111110011011111011111111111111110111111101111010011101110111111a111100001110111101111101122221122212222021112212102121a001a1100110111101101111101111111011011101
111111111111010001111111110111111101101101111100111111110110111a111111111100111101111111101111101101111111110111101110a101a1111111111111011101111111111111100101
101111111101111111111110010111011111111011111111110011011111111a111110111111010110011111111111001111011101101110011111a111a1111010111110111111111110110011111101
111111001110001111011111001111111110100011111101111110100010111a010010001011111011111111110101111011010111011111110011a011a1111110111111111100111011110110110111
111101111111010100111111011111111011101100011111111001010001001a110100110111111100011011101111101010111111111011110111a011a1111111111110111111111111111100111100
111111111111010110111111111111111111111011111111111010111111111a100111111110111111010111111011111110011111011110011011a101a1111011111000111111111101001111011111
001111101100100011111101011111110000111111111111111101100111001a100111001111111010111110110011111011111111111111011110a101a1100111111010101110110101101111110011
110101100111110101111010111111101101100111011010011111111110111a110011111101100111111111111011111111001111111011111111a111a1111011011101011101111111110011110101
111111111111001111101110101101100111110100110011101110101101111a111111111111110111111111100111111110111111111111011110a101a1111111111111111101011111111100110111
101101111110101011111010110000110111111111111111110010111111111a101111101111111101011111111000111101111011011111101111a101a0111111010111111111111101110010110100
110011110111111110110011011011111111111101101111101110111110111a101111111011111111011100111110101011111101001110111110a110a1111110111110111111011011110101110010
110011110001111111111010111111111111100111101111011111110001111a111111111111111111111111111111011111101111111110111111a111a1111111010111111111100111101111111111
111000111110111011111111101110101101110101111111011110111010111a100111101111101111111111111011110111111111101011111111a011a0110100011111101110111111111110111110
aaaaaaaaaaaaaaaaaaaaaaaaaaaaaaaaaaaaaaaaaaaaaaaaaaaaaaaaaaaaaaaa110101111110110101101111111111111111111001111111111101a011a1101111111101011111111101111111111111
