102 17
5 151
10 115
63 73
70 18
6 132
95 71
48 134
37 12
71 30
1111111101111111110111101111110100001111111011111110111111111111111101111111111111111101111111110001222020221121101112221202221221222121211212112100011111111101
1011111101110111111111111111111111111111101101111111011011011110101101111111111110010111011111011111221122212201011121221121220022002201112102112221111101100111
1111101111110110111000110111111111110111001101111011101111010011010111101111111011100111010011111111022212010110201111020202210212111012222111100221111111111011
1100111011111111011111111111101100111111011011111001111111111111011111111111110011111111111011111010212220202122121112020012222120211212222121112222010011101011
1100011110111101110011111111111110011101111110111111110111100110010100101010011111110111111111011111011111221112001202122120121102120220221222120101111011111110
1111111111111110011110111111111011011111011110110111111111011111111101101111111111110111111111011001122222020220211211200222002222012222220010012021111111101001
1010110110111111011011011111111000011111110111011011011111111111111111011101010111010111111101111111220222110110112211222122222021211120022111021002010111111111
1011111111011100111111111111111111011101111011110011101111111111110111110101001111111011011011011111121021012222021122221222221012212202220111111212110101111101
0111101010101011111111110101110111111011111111010110111111111111111110111111100100111111111101111111111022002110012002212222112222220222220101112102111101111111
1111111101010111101111111101101111011111111111110010101110111111111100101011111111011011101111011011221012122121221200211112002222121220112111222121111110100001
1111111111111111111101001111111111111111111111111111111111110011011111101101111111111011101110111110121121112011122012122220211220212121112201220121110101011111
1100111111110111111100111111111110111011111011100100111111110110101011111110111111111111011111111101220220221111222210002202122021121120011001212111111101111101
1110111110111111101111111111111111001111111111110100111101111101111111111100011111111001110111111111210022112222212202122022122201202001111110112211111111110111
1111010111011011100111011111111111011101001111111111111111101001111111101111110110111111111111111111012221120211022020210001102202121121221102111110111111011111
1010110111111101111111100111101111110111100111110111111111111011111110111011111111111111111110001110122221202012011021221102221220121021222200000200110110110011
1111010111101110111101110111001111111110011111111111010111100110111111111011111111110110111101011011121220111001021210022102122202202121221222121111111110111111
0111111111111111110011101101101001011111111101001101111011111110111111110111111111110011111101111110200010212222010001220202020121211102111211022220101010101110
1111111101111111110011111111010111011111111101111110111011111011110001110111111110111111101111111010212120111001211111122221220201022211010122111212111001111111
1111011111111111001111101101111111011111111001011111111110111101001111101111101101111111101011000111112101101012122212221011022100211120110210021201111110110111
1111111010011111101110111111111111011111111001101111111111111101111001011011111111111111111111111101011211122021021101222221220201112201112111122201101110101011
1111101111111101110011111110111111111110111111111111010111111011101111111111110011110101000101011111122122021111122122222100222100211101221111022010111111111101
0111111111111111111011110101011110111111110111111111111011011110110111110111101110101110111111111011121210122122222212012011222221022121120212211121111111001110
0212112221012202222202011210101111110110111111011111111111111001110001111111111101101111111011001110001221110221202122022201112222111101100101011110110111110011
0021110101111220111011012211100110110100111110111111101100001011100011110111111100110111111111111111002222122121201121022210012211011111111111010110111101111101
1222112212211021211202020121111111110110111111101101111101101111110111001110111011111101111100011010210221021001022222122221021011211100111101111100101101111110
0121121112121211211212021021111101111111011110110111111101101110110110111110101101111011111011010111202200012111102202221011000201111011101111111011110101110110
2102001111202202001201111012111011101111101110111100011101011111111011011111001111110101101110111111111111110101111111101110010110010101110111111110101111111111
1112212212012212121012010122101111101111111110010111011111110111101111111011111111011111111111101110101111111010111010110110111001011101101110111100111011111111
0012212110222212102111101022110111111110111110111101111011101110111111111101011111101011101110110111111010111111111111111010111111110111110111111000100011111111
1002221111112212210222212101111101110011111110111011111111111111011111111111101111111111111111101011111111110111001111111001110111111111111110011101110111110111
1101111102211120220111121221111110111111111111111110111100101111111101111111111111111111001111111110111110100101111011011111111111110111011110110111111111011111
2111222122111010212101122011111011011101111111011111111111010101111111110111110110111111111111110110111111101111110011111111111111010110011110100110111110111101
2112101120110100201102120121111010111101111101111111111111111111111111111111111111110111111111110111101111111011101110111111111111010111110111101101111011111111
2012021211011120120220100111011011111111111111101011111111101111111001110110110111111101111111101110111111111111011111020011010122102222111201211210211111111011
2212021211111210212222121011111111111100011100101100111101101110011111100111111011111011111111111110101110101111011111111222122202011220120221221120221101100111
2210102022220110122202222101111101011111111111111111111111111111111111011111011110111111111010111101101111011101111111101222011121110021012020110111121011111111
0220221001212122111202111201011011101111111111101111100111010111010111001101111101101111111011111111111011101110111111122110121221012112100212221020011111011111
2101122111010112200122202222111111111010110111011011111011011101101111110110001011111111111011101111111011110111110111101101221211211101100222122201001111101110
1112101112221222200112211201100011011011001111111101111111111111111111011101111111010111111110000111111111111110101101100212111101211100011221120202000111111110
0112011020121112101111221122111111101101111101011111111111101111111011001111110111111011111011101101010111011110101111112110221122122122222121020122211000011111
1221210221102112122010101201111111111111110011111100010111111010111111110101111111001111111101111111111111111111111010012222112200001122121221122221111111111111
2121221122100002021210012211101111101110110111110100111010111011110111011011111111101111111111010100010111111111110000110112011112212112211121202102221100101011
1201110001111120122112001212111010111111110110111100011111101111011111111111111111100111100111001111011101010011101011010112012212121021220221212201221011101111
1110222121100210220112210220111101111111110111111001111111010111111011111110111111111101111101011101010111111101111011121122221122121101002111121221210111111111
1222210201120221201101111212111111111110111100111001111011111111111011110111111111011111111110111011111110010011111100011221220211202222222011212200220111101111
1212202111112211001122010011011101110110111001111110111111111011011111111001001111111111010111011111111001011111100111021110111220121211222212122120121111011101
2111111210120011201211221210111111111111111010111011111111100111101111110111110111101111101101000010110100111111111100122000221111201212211210112222201111101110
1022102201201201220002102012110101111010110111011001111011101100111101011111001111111111111111011011111111101111110111020022111201211100001212012011121111111111
2022100212202112122211111110111011111111111111011101111111221122111121022112122111112111010111101100101111111111111011121112122212212220211222210221111111111111
2121120221012011001010121022101111011110101101111111111001212211211212212000221112121201211111010111111111111101111111121112101111120012011200201220201101111111
2110212021220112112021201122101011110111111110101110101110010022222102102021122221102011211111111011111011111111011011000201212020212010110202101210201101111111
1101112021012112022211111212010111101110011111101011111111010222202111121221211122112122211111110111110111110011011101000122112111210111222012010202101111101111
0212112212201102102200012112101111111010111111111101111011200112202122212112221111011122101101100000111011111111111111122211122202011111212212221121221110110111
1011111111111111110011111110111111111111101111111111111111221111121111122201211011010111210111111100001001111111111110122102122011022122122211122101211010111111
1110111111111010101111110011111100111111011000101011011111022211022122211212020012221222211001101110111011111111111110102210121212201221211211011210220101111110
1112110212121101012221112121221211111011110011111111111111112220111011221012022210110110211011100111001110111111111110112011112121200112110111212212001001011111
1010121001221102220120212222112212120120122121110111110011222122220212222001112112112121101111111111101010111111111110112121200111112211202020011102211011111111
1011222021022022220202222122222122122222121121111111110111021212220121011110222012012011210111111001111111111111111110111000221211211220022211211002020100111111
0112202001110200002222200202122022111011122120011111101111220222222211012111110212121011010111110111111111111111110001112111020111022100010111200122020111111111
1111112020011112202212012112122222111012101212111111111111021221101112101221111112012112011111111011111011111111111111122021112102111012122102111211211111011110
1011012221222121112210222222022212111011011022100111111101112212211222220111121220112222210001011010111111110101111111110221201121110000110211122212121101110111
1111100022122001220202121102002120122111122212111111111100221220022201201122212111202122211110111110111111111111101111112001122221221121101121211222221101111011
1112110112202002222010220221100202111010000222110011111101201010220121121020112122111010100110111011111101111110011111102211111021220110212221110221101110111111
1102000012212122202201201112211201122122220100111111011011120211020111022002111222210221111111111111111011111101011010101122012222201111002121110012111111110011
1110111111201212001222221202222001221100012122111111111110122211202112221022201002110222210110111011111111111111010001111110111110011111110111110101111111011110
1101112111112022220222102221222211212002212002111011110111101120122202221011020121210112211101110111111111101101101111111111101100110111111111111011111111111110
1012112011201222021202122112220202012120211122010101111111211122211000111122211121011211000011101011111111011101011111111110100011111111111110111101111111011100
1111101210000122201202010020222200111201200211110010110111222212110222211212122102101121211011111011111011101111111101111100111111111111011111101111111111111111
1111120101000112222022212222221222102110211212101001111101102011101121010001200022100022111111111111111111011100111111111111111111011111110101111111111111111101
1101211111211111210200102212012200110011212111111011010111212221111210220122211212201111111111110111111110111111011111010011110111111101111111101111011110111011
1101201020201012012120222222221220122001011012111110110110212220122221222221111212002020110111110100001111101111111111111011111111100111101011101111111111000111
0000012111121022221202100221020121020210021100111111111110222202222112022020121201220122111111010110011111101100111111010110111111111010111011111011111111010111
1111102122112202222220222220221211001021122200101011111001221121112220122221202211201121211111001111110111110101111011111111111111110011111001110101111111111011
1112022022212112022121222222201222202122002201011110100011112201111111102112101221112221100011101111101111110110001101111111111110111110101111111111110110011101
1111111001112022102100221220022212111222122222111111110010112112121212210002121201202200111111111111110110111011111011111100110110011111011111101110101111110101
1112220220222221221100210212221222011111102202111111111111212201122202120011201001022020110111111111111111111111111111110011111111111111111100111100111011011100
1112202111222021222001220002120202121121112111011111111101220221210002020100100211122201211110111111111110001011010111101011111110111101011111011011111111110110
1102122211011120212020221020222121221110210221110111101111021222221021212001111122102111011101110111101111111101011111011110110111010001111111111111111011111000
1102222020012102010222211022212220121122222110111111111111112121221000201022001121202200210111011111111111011111111010110010001111011110111101011111111111101011
1012002201212211211010222020222202111122201202101111101111100000101111111101111111101111111111001011110011111101111111010011101111111110111001101011101111111001
1001002120222210122021022022210021221022222000101011111122020222201111022122022021221211110111111111110111111111111111111111111101111110111010011001100111000011
1101021222101122200110211220202222220222211202111110110112210001102201201111001121112101111110111101110011011001111111010111110111011111101111111111101101111011
1111102112111212122022212212212212012222111111101101011111222120101111212212221221010001111001111111111011011100100011011010111110111111011011011101011111111011
1112211110220211222112111011002012221222222222111111101111210001102120102120222012212201111111110111111111111111111111100111111111011111111110010110110101010111
1111121011022120022221222212222100020102212112101011101122110201210122011121212121212111011111111101101111110111111110110111110111111111111010111110111101011011
1011022222201012112122222220222021021212010022111010111101221010200021021111011200201211101111101111111001111111111110011101111111111111111111111001111101110011
0011101111111011212222101010212102121222222122111111111121110221211021222222220222211221111111110110011101101111111011101001111111111011111100111110110111011111
1111001111011111111111011111111111100011100111001000011102011112111002102120222011002221101101110110111111110110101111111111111101011110111111101111111101101111
0011011101101100111111100110111011111110111110111111101122000112202112202220102111211121110011111011111111011110111101110111111111111111111111111110111101111111
1011111011100100111111111111001111111111111111111100011021122200121122110110002111222011101111001111011111110000011111011110110111111111111100111011111111010111
1111110111110101111110100110111101010011111011111110101121011211122001121220121021111111110011111111111111111111011101011011111100111011111011111100111010111110
1111011110110111111111011111111111110111111110111101111121012221110112110121111121021211111111111011110010111011110101110111111111010111011111111111111111111111
1011011111011111110110101111111010101111100010100111011121220220122101012222221110122111101111101110101111111101111011110111111110111011111111110111111111101111
1111111111011111111100111111111111101111001011101110101101012020210111111101222112011121101101111111111111111110100111111010111111111011111110111101011111111011
1111110111111111111111101001110111101011111100111111111102111120111101022122211121202211111101110111111111011111001111101011110111100111010101111101011001110111
1111101111111111111111111111000101101011010111100111111111011201222022111102212101111111000111111111011001100111111111111010110111110111111111111111101101001111
1101111111111101111111111010011111110010111010110111011112102021221201121101111210020221010111111101101111111110110111011111111111010101110111111111101101111011
1111110011011111111111011111111101111010111010111111111002221210100121211111021211112101101111101111111111110001111111111111011101111010111111111111111111011110
1111011110011111111111111110010011111111111101010111111121202210101111111212022012121221011011111010111010101111010111110111101110111111111111110110011101100111
0110111111111110111111110111110001111111001101111111011111111200222121222220110021022121110111101111111101001011111011111111110111111111111101101110111011011111
1111111111001110010111111111100111101100100011101100101102102211112021111000001222001211101101111110110111111111111011111111100011101011110111111011110111110101
1100101111111110111100111111001111111111011110000101111120111101011122221112111102221020111101111100110111111111011101110111111100111111110111111111110111011100
1101101001111001111010011111111111111100110111111000011010111222012220020221222011111221101111111101111110111111111111111111111101111111100111110001101100111110
0101010110110011011111111110110111111111110111101111110112102021110121111102200122111111111111110111101011011111011011110111111101110111111111111011110101111101
1101111011001111101111111110110111111111111101111111011012121221102122002211012112021221101111011101101000100101111110111110011111001011101111110110111011011011
0110101111111111111111111000101111011111110111011111010121222112012100101112110111120210011111110000111011111011111111101111111011111111101000111111000101011111
1111111111101111101110111110111110101011100111011011110112202122022212120212111202221120111111011011011000101111011001111111010111011011110110111011100101111001
0110110101111010101101111111011110101111101111101111101102201120222122201110122212222211111101101110111111111111111111101111111110111101111101011100111101011111
0011110111111111111111111111111110010111100110111011101112100200120020211211112221021211111101111111011111101111111111111111001110111101100101110101101111111111
1001110111101110111111111111111110111111001011111110111120222222122121110020011112012111101111111111101001111110101111111101011110111101111010111111011111111111
1101100101111111111100111111101110111111110111100011100122120220021122102112110201121211111011111110111110101101111111110111011001111011101110111100011111111100
1111111111111000011110110111101001111110011111111111101001011110101111110111111101111111001111011011011111001111011011111011111111111110111010111000100111111111
1110011111111111111110011111111111111101111001010111010111110011111110110111110111011111011111111010111011111111101111011111111111110001111101110011101111110111
1111111110001111011110111111101111011110011001111111111111111010100111111111110011111111111110111111111101111111111011111010101111011111111110111111011111010111
1011101010011101110111000111111111111110101001110110011101011011111111111111110011000111111111111111011101101011111111011111000101001001101111100111111111111110
1101101101011101111111111011110110111111101111010111110011010110111110011111011001011111110011111101101111111111101010111111111101111011111111111011101111010111
1110101111011111111111011101110100101100111111101111111111110111110001101110011110110011110011110100111101111111111111111001111100011011111111111111010111111111
1111101111111001111100111111111111111111011100111011101110111111110111010010111111110110110011011111111111111111111111011111111110011111111101111111011001111111
1100101111110111111111111010111111101101110111111011000111111100111111111110111101111111111101111110110101011110111111111111011101011011011111011111011111001100
1111110011110111011101111111111101101111101101111111111011110111010011111011101111111110111110111101100001111101011111011011111101100111111111001111111111111011
