20 146
5 20
20 90
64 24
47 155
9 107
63 8
46 95
99 26
90 140
10011110100111101011111011110111001101111111100110110100111111010110001001101a11a11100111100012121111002212210b2021201111221010110a11011110111111100101011111111
01101101011111011110100101010011011111111110111111101101111011111111101110111a11a01101111101110122210122101100b2111201012211111111a11111110001101111111111111111
11111101001111110110101111111110100111110000111011101111110111110111111111011a10a11111111011222202011211010212b1220101112221110111a11100011111111011110011111111
11111111111011110111011011101101110011101001111011001011111110101011110111110a11a01101111111222222111112212110a0222211201111111001a11101111101101111111111110101
11111111101011111011111111111110110111111011011111111111001111010101111101111a00a00011001011102221222201021220a0002200222011110111a11111101111110100110111111111
10011101100010111110111111011010101101111101110111001111111111111111111011111a01b02111120111222122101220220112a0201021111121101110a11001111111101111110111011110
10111011011111011111111111111111111111111111010111110110011101111111111110111a12b12220211222222100220221201211a2212220221121111111a11011110110011011111011110011
11111011111111111011111111010111111111011111110111101101110111111101011101121b10b10022001120011222221201222101b2221112201200101100a11111011111111111011011110111
aaaaaaaaaaaaaaaaaaaaaaaaaaaaaaaaaaaaaaaa0011111011111111100111110111110111121a12b12110121011120000222102221221b1220222220111110001a11111001011011101111110111111
111111111111111111111101011111111111111a0111110011111101111111111101111110112a21b22121202212222022221200222201a2012112212021111111a01111101111111101111111110111
111111111101111111110011111001101011111a1101111111110110010101111111110111100b02b12111111012220112102222221111a1021222222210111101a10100111111111111010111001111
111111011111111110111111110111110111101a1111111011010110111111111111111011111b22b21220120201212222102022021021b2101112212111111011a01111101111110111111111111111
111111011110111111011111101010111111100a1111111011101101111111000111011111122b02b20111112102220210221212101212a2211101112211111011a11111111101011101101110011011
110111010101111110110111111110011101111a1101101011111011111111111111111111021a01a12212221111120212220222221001a1202110002211000011a10111100111011111001111011111
111111111110011011110111111111111111101a1100101111111110111110111110111001120b22b22212120121012102221221222220a1002212210211111110a11111101111111110111011110111
111111111111111100111111111011110101111a0111111011011111111111110011011111122a10b22010202221021222001022221102a0222001212110111111a11000011101111110111111111111
110110110101101100111001111111001111100a1110110011111111101111011111111111021a22b10011221121122022022220001122b2110211202100111110a11101101110111111110101111111
011011111111110111111111011111011111010a0001111111111111111111111111101111121b21b01101121212211222021121002200b1111211022021111101a11011101110111111011110111110
011011110111111100111111101101110111111a0011010100011111001011111101111111110a12a21110122012112200222120201202a1112110110111111100a10001011111111011011111111101
010101111111111011011111111010111111110a1011111101101111111110101010111111012b12a02221210212222112221112212111b2020111220100011001a01101111001101110111111111111
110101010110011111111110111111110111011a1110111011111101011111101101111111020a12a10022211000022212201201201221b1122111211200111111a11111110111111111101001111011
011111111101111110111111111111111111011a1111111111010011110101011111111011112b20b10220111210222212222221120211a0012102210111110110a11111111111101110111110101110
101111111011001110111110111011011110111a1001111110111111101011111101111011111b10a20201100201221221101222112010a1212110120001001111a11110111111111111111011011111
111111111111001110111111101111111011111a1111111111111110011111111110111011012b20a20112122201202021022212212201a2212121111121111111a11100111101011111111101011110
111111111011111110101111111111111110111a1111111111110111111011111111110111112a00b20221220102200212210221022110b1011022022001011111a01101110111111111101101100111
110111111101111110111110110010111011111a1110101111111111111000110101101111112b00a10221201102222101012021220011a1111111111111101110a11111111111101111111111011110
111111011111100110111011111111111001111a0111111111010111011001111111011111101a20a12201022012021221110202111111a1101111001111011111a11001111111111111111110001111
011101101111111110011111001111111110101a1101111111001011111111110111111011021a11a11211222221222002122122221111a1111110110111111101a11111011101111101111101011110
011111011011111100111011011011111111111a1111111011111110101101110110101111102a00b02012222212001011120000121010a1111111110011111001a11011111111111111110110111011
101111011101111110111111110111111001111a1000001001111101001001111101010111111a10a22201201121111002000210111001a1111101111000111010a11110101000010110111101111111
101101100011111110011111110101101111101a1111111100111101011011111111111101012b22b22222212122221200121201020111a1011001100101111111a01111110011111011011101101101
111001111101111111110111110100110111111a1110110111110110111111001110010111120b10b22122122222212222212102021221a1010011110111111111a01011101110111001011101011110
110101111111111111011101101111111011011a1111111000111111111111111111011100021a11b10122012100222122020212222211b0111001111111111111a11111010122220221220220212101
110111101111110111011010001111011001111a1111111100111111011111111110111101111b01b00222210202221220122022221212a1011010111111111110a10100001120122121210211200112
111111110111101100111011111111111111111a0110111111110111111010111111111011111a12b02200220222221220020100221011a0011111101101000111a01111011122211221122010211000
111111111011111100111111011111110111101a1111011111111111001000111010111111112a01a21122220110202211212120011221a1111111101011101111a11111011111111011122021102100
101111111011011111111111000111011111011a0111011111111110111111101111111111101a11a11000221222021121111211210222a1111111111111111111a10100111102202221111012210222
111010111111101111111111001111111111101a1100101111100110111111011111100001110a01b12111011120020102220102111121b1111000111111111011a10101111101102211201101121002
101001111111100111011101101101001101111a1111111110010011101010111011111010100a11b11222010212110202111101111111b1111011101010111111a11111001120122112112122021022
111110111111111111111111111111100011101a1111100110100101111011111111111111001a11a21212202101112002101122112020a1111110111101101111a11111011022212021210010211122
111111011111101101111111111111101111111a1111011111101110111111111111111111101a11a00022101212212102120012010222a1101100000111000111a11111111112120122112202201110
111111111111000111011110111111111110010a1111011111111111011111110111110101101a01a21211201011010111212211201011a1111111111111111111a11111111120111011121122122011
101111101110100111011111101111101111001a1111011111111111111110111111111110000a11b00120210112202220211220201110a1111001111101111111a00111001121212200111100022212
110111111111111000111101111011111111100a1111111111111111110110111101110100101a11b22112221111220121202012220021a1111111101111110011a11110111020211110022021212220
110001111110010101111011110001011111111a1101111011100001101011111101111111111a11b10122220021011110021110011002a1001111111111111011a11010110110221011120122121210
111111011111111101110110010111101110101a1110011111111111011111111100111111111a01a21011122220111121011201222000a1111111011111111101a11110101112121220112212122201
111011111001001001111110001010110111011a1010001101011100111111111111101111101a11a00021102211122022222012212202b1110111011111101101a10101110011221111200122102111
111111111111011101111111110111100001011a0111110111111100111111111101111111111a01b10211222021111210202101122221a1111111110111101000a10100111100121122202100221021
021212112111111012222200001111011010001a1111111111011111110111111101110111110a11a02212012222212100111201112111a1111100111010101111a11111111022001111110221022012
011021221222021221202210221211021212220b1011011001101101011111111111011101110a11b21122222111011211212121100222b1110111111111111111a11111111110000120220012221222
002010220220222121122222120222200101221b0110100111110100111111110111111011011a01a21112002211002202012210101021a1111101111111110111a11110011121111122111102210100
112211121122122222211222022211012201122a1100010111111010111011011011111110111a10a12122122122112101010201111211a1111011110101110101a01111111101020011000111222220
120101202220212222202221101022110021221b1111011110101011101111010101111100111a11a12220020211112221012221122121a1111111101010111101a01100111120222212121211121200
110121222222112202222002202222121212102a1111111111100111101110011110011111111a11b21202121021220021112202202221a1101010011101111111a11100111121201212200101222222
110012212122122100220012012222221012201a1101111110111111111111001111111111000a10a21022111212001222112101122021a1111110111111101110a11011110111121201022022220121
210111001202222122002110112120121222212b1100010011110101111110110111111111110a11a22101212122210211112212210111a1010011111110110110a00011111121121110221121222120
221212220221222020120222120122211102010a1111011111011101011011001111111111110a11a22112210100122222011221010010a1111010011111111111a01011100110020111011210211021
221221221122222021212211221122222212111a1111111011110011111111111111111111101a10b22120002121012221211002012202b0010111111111111111a11111111121111102021121210112
100222221222202100222222112122202211221b1100111111111111001111111011001011111a10a21212021210222211102211202202a1110010011111101110a10111111112120202021110221022
210212110200220201102122211120101022210a0111111111111111011111110111111111101a11a02120222201211012211122110120aaaaaaaaaaaaaaaaaaaaa11011111022221221222022121121
202021102202022120112022022111211112212b1001111111110111111110111111100111111a11b1011102210122211221112012211121111011111101111111101111011112221112122122101211
212112102112221222222122111212200211202a1110011111111111110111111010101011101a11b2111120220210002102111121200011101111011111111111111011111102101212221002112002
122022212202210001020112211221100011012a0011101110111101111111000111111111110a11a1111111111111011001111111111111101111010111111111111111111112122111121112002222
101221102022202222201220122220112222011a1110010001001111111110111011111111111a11a0110110101111111101101111111110011111011110101011110110001111101011011111111011
002122222202202222002220021221222212202b1000111101111101101110110100111110100a11a1001100111001010111001111111011101111101011011111111111111110011111010111011111
222221001210021222200222221211122201221b0101111101111111111100110111111101111a01a1111111111110111111110111001111111111101111111011101110111111111011001100111101
211211201102221021222202212102122121220a1111101001101101011001111111101111111a11a1111111110111111011111011101111111101101110100011101001101100110101111111111111
121222210021112021202202201202110200122b0110110001110111111111110111111011111a01a1111110011111110111111101111111101110111101111111111110111111111110110111111111
102120012222202220222222220101220102001a1010110111010100101001011111111101110a11a1111111111111011110111100111011111110011001101111001100010111111111011011011110
122212211221210212021222022211012111112b1011110101110111001001111111111001110a11a1101101100011101011011101111111111100111111110111101100001011111110111111110111
110122220221202212222022102212211210110b1111010110110111111011111111111111110a11a1101001110111111011111101111110010110111111101111111101011111111101011111110100
122022221212122122222221102211012212121a1101111111111011111101111111101111011a00a1111011011111111111011010101111111100111110111011110101001011100111110010111111
222220111220122122220222121100212122111a1111011001111111100111111110111111110a11a1111001111111011111100111111111101110101111111111110010111101111111110101111111
210211221212121222010222011212222222111b1111111011111111101101110101110111111a11a1110110111111110001111111111111111101010111111010111111011101001011110111111111
201220112211121212002221022122201121201b0011101111111111111111111101111000100a10aaaaaaaaaaaaaaaaaaaaaaaaaaaaaaaaaaaaaaaaaaaaaaaaaaaaaaaaaaaaa0111111111000011111
101112111022221122202122100121111201221b1111110111111001110111011010111111111a11110011100110111101100111111111101110101100111212111111111011a1012111211201101101
122012021212222100122021111211122112001b0111111100100011111111111110010111001a11111111010101111101110011111111011111101111111201110201002102a2110110211212201111
112202211222202020221222220101220111220a1111011101111111101101111111000111110a11101001101011111110111100111111010111010111111021221020222122a0000120121122110111
110121100222121222222211122101011220122a1101011111111110011011111111111100001a11111110111011111011111111111111011011111111110102212221221221a2211200021122101111
111011111201012212202121122011020102122a1111111110100111111110011101111110111a10011110011111111011101111111111111001111001111112011222102102b1120022112012121110
011011111111111101011111111110111001111a1111001000011111101110111100111110111a01111111111111100110111010111111111011101111111112212201101210a2120212201212121111
111111111111111111011111011001111111011a1111110011111011011110111011111111111a11101111111111111110001111011111011111111011111120121012211112b2221222111222111100
111111111111110011101011101110110101111a1101011000010111111111110111111101110a11111111111111110101110111111111110011111100111221111201200012a1121201222100201010
011111101111011110111110110111110101111a1011111111111011111111011101001101010a11111110101111111110110101111101010111111111111112210012121110b1112220112120211101
111111111001121011210010110021102011110a1010111011111001111101111111111110101a00111111111011011111110110001111111101111001110012111202112111a1212100111220211000
111111011001111212012212011211020120000a1111111111011110111111111101111111101a10011100111011111111111101011111011111011110111122222121110100a0021122022120221101
110110111112122122012221021212212222211a2211011111111111011110111111111110011a11011011101111111000101010011111111110011110000212211221120011b2001211121111111111
111111011112121222221101001221212121221b2111101011111010011111011110111011110a01110111110011000111011111111111101110111111110221222211122011b2200201222110021111
001101101111002002021121012101211211211b1111110101010111011110110110011010010a10111011111110011111011111011111011011110111011202222220122221a2110021121110121111
111111111111100200212122221111001022211b1211111111111111111011110010011111111a01111011111011101111111111101000111111101110111100221100220111b2011011102201111111
101111111011202221200112002211211202202b0111111111111111111110011000111101111a11111111010111110111111111110101111111111111011020121122122110b2100201212211200111
111111111101202221122202121220112210011a2111111111111111011011011110110011111a01100011111111101101111010111110111111111111110201211102211221b1211001220110211111
111110111112102021120112222011002110222a2211111011111011111110101110010101110a01011111111111010111010110011101110001111111111000212122202000b2011221111210120111
101100110112121100012200020002111110121a0101101111010011110101011011111110000a10100111011000101111011100101101011101111111111110012201011221b2122221122212210111
110111111100201101121121110212120212010a2210011100111111111110111111111110111a01011111010111111101111111011111111111111111111111121112212012abaabaaabaaaabbaaaaa
010101111011021110101112221202212222212a1011110011110111110111111111111011110a0011001111110011111101111011111111111111010101110222021111222012211122021122211011
111111111010222121112102102102021001010b0011111111101110111111111011111111111a1111101110111011111111111010010101011111110111122122220212120022111011222210221111
110011101112122021212021102022012222221b1110111111110110010111110111101101111a1111101111111011111001110101110111100111111101122122021212212121002120221210111111
101000111012111122002122222212212102202b2211111011101111111111101111110111111a1101111111111101111111111100111111101011101101101100121211001102221212210021011101
111101111100222121020222202122122201121a1011101110111111111111110110111101110a1111111110010110001111101101111011011110011111112011112221010121122002221112220100
111111111111121122221200101212210112011a1111111101111111111111011110111111111a1111000111110111011001111011110110110011101111002222112021222222121212010120120111
111111111112111021220122122222022112220b2101101111110111111111110011110111111a1110111111101101111111101101101011111101011101120221002002210221000121210022221111
111111111102110222210002112221110011112b0211111111011101011110100111111101011a0111101111111101111101010011110111111111011111122002010112212201221112211100111111
110101111112221200200112020222121221200a0211110010010110110111011011111111011a1110111100011110011111111111101011111001111111122122212221101122121221201220021101
111101111011101020211121202212011210012a2201101111111001101001101101111101111a1011101111111001111110110111011101010110111110110112012120110011022012200002101110
111110111010002101122212202121211111200a2101111111111010101001110011111011111a1101111110111011111111011010111011111111111111112011220122200022211211022022221111
111110111112022212022211202122122002122a0111011100111100110111111111101110010a1111111111111001101111111011111101111111101011111101011110101101111111110110111111
111111100102002111221102020102221110211a1211011011111101111111110110001001101a0111110011111011111101010111110111001110110010111110111110111011111111010010011111
101101111102110121221011012021200101112a0111111101111101111110111111100111101a1110011111010111001110010111111110101011111010111001100101111101111111001111111011
010110110112220100110211121120202211112a1211111111011111111111110110110111001a1011111111110110110011111111111111001111111001111111110111111111110101001101111011
111111111011012222022001112201221201102a2111111101111111111011110111011110111a1111101001011100111111011101101101101001100110111101010110011110011101111111101111
111110111012222211220011012221211102210b2201011101111111011111111110101111101a1111111111111101111010101111111101010111111011110111110101110100111110111011111111
111111101112112222110022010121112020112a1210111111110111111100100101110011111a1101011100101111011001101111001111111110111110111111111111101111110010110011011111
111110111112211120122010221222121222121b1211111111011111111110011001101111110a0110011111011111110111111101010111110111111110111111111111111111101100101111111111
010111011112211201012212112111222012022a2111100111111111111101110111111111011a1110111100111111111110101110111111101111011110110111001111011011111111111110101111
011110101111111111110111111111100101111a1111111011111111111110101111101001110a1111111010111111111011111111111111111001110011111101111110000010111111110111101001
010111111110111101101111101011101110111a1111111111111011001111011111111111111a1000011100111111101111111011011111111011111101110111110101100110111111101111101101
111111011111101111100101111001111011111a1110111101111111111111101110110111011a1011111111111011111001010111111110111110101010111111110101111000011111110011101010
111111010110011111110111010111111111111a1111101111011111111111011111111111101a1111111010111111111111011110111011111111110110101011011111111111011110110110111111
111101111110101111010111110111111110111a0111111111110111111111111011111101111aaaaaaaaaaaaaaaaaaaaa11101110110101010001110110111011110111000110111001111101111110
