116 156
119 6
32 142
54 81
5 93
53 142
26 16
17 35
57 103
106 42
1111111111111111111111111100011011100110111101110011011111110001101111110100112210022221221221011021210112212111111111110111011011111111111011111111111111011111
1110101100111111110111111011111111101110111100001111111110111110010011111111111101111101211020210121121211222111011010001111010111110111111111110110111110111001
1101111110110111111101020000221012210201121102202111011111111111111111101111111222102121110121121112222111221111011010011101011111101011111111111111101111011111
1110111011110010110121212120022101120102121212101101111111100101110101111111111222012000202102112111122112221011101111111111111101101101111111111110110111111111
1111110111011111111111021221100121222000012020120121111111111111111011111101011121020111011202121122011021111111111101101111111111111111111011101111100111101111
0111111111011111111111022022201212012120111021001221111111111011111111111011101212100222122020021112102121101110011101110111011111101100011011111111011111011010
1011110110110111111122112021112122112111022122221121011111001111111111111111011211101111110221122011101122122111111111111111111011111111111101111001111001011111
1111101111110111111120110112201212122122111222120001111101110011101001111110012012012100121210020110101002201111111001111111111110111011111110110110101111100111
1111010011110101011121120122011221122210012202200201011001111110100010110110111212122111212021010222012122210111111111110111101101100111111011111111110011111111
1110101111101110111120120121212201210211102211120001111111100101110111111110112010222222122101221111112002212111111111101101111101111111111101111110111101001100
0111011011110111001111021012222202011201112110020221011111111110011101101000000222221020121202212220122100201010011011111111110001111110010111011111111101111100
1020212101101020212002022220221001202121112121110211011001111111110101111111112111102202121111101112220221221110101111101111111000111101101100101011110001101101
1011122020212210210022202212220202210212101122001210111011111101110111111111112020112112212012222210200112112010111100110111111111111111111011111110111010000011
1201021002122111111220211112212111222221021020211211111100111110111111001011112112022221101222222210222000221101111111111111111111111111111111110101101100011111
1221121212220111112012122002002210222210002110010021111111011011111111011111112112102212112120212122121221221111110011111111111111111111001011111111111110011111
0120121112112201121222220112122221202000201012211201110110111110111110011111112102002211212011220012012220012111111111010101010111011010110010110110111011111111
0021221221221120121221222112212221221011220002011110011101010111111011111111112222211022122010222111222112110111111101011111101101110111001111111111111111110010
1022021121010000202122121201222212221221012220022121010101111101111011111111112121002221112222122211112021011101111011111111101212011222221102121200211121001011
1021101212111222122212222222202021011111221212021100110100100110110101110111112111121121112111112121120212222011110110111111011220102210111122120112122111100211
1111210122111211011211222222220202222212211122110200111111101111101111111010111121202112121102212111102001212100100111100110011221210122120122120212212022122111
1212012221012120212221201220222202110011010121111111111111010101111111111101011201222120011022112012121212211110000011100111011120221110212121212120100202111201
0221011210120121001122122222021121121110210222122121111101011111011010110111111111111100001111011111111101010111011011111111101111011011121121012101111101220111
1020212221212201110222222101122101120012221121211121101101101011111111101111100111111111011111111111100110110101110101111101111112221120221101102022222222202211
1101111200221212201222212200220122221112222112111021010111111111111011101111101011111001111111100101011101111111110111111001111112220012121211101221221210011101
1221100120022121212111222222220212201022212221212211110111100111111111010111111011011110111111111111110111111100111111101111011112222110211122112012100112222011
1210022020022201202122212102121201212110222222022201111111110111111111010110111111110011111110111110011101101111111110110011101122201220112121111121121111112211
1211121110221210212122220212022010211220012202202220111100111101111111111111101011101101111111110111011111111111111010101010101102221200200012122101112102011201
1122112221101001211122222222012111110101221121120101101010111110101111111111111110111110101111011111111111111110101111001011111122211110101122001022120011220211
0220220102010112122222122211220212200102210112222210011111001111111110101011101011111100101101111111101100011111111111111111111222020122202202202020110211200110
1121221011221012101121222202201111120102201112111210011111100101001110110111111011110101111111101101110111011111100101011001011121221011221211111200110110202110
1102121111021111022012220121012122212212102221101111111111111001111111101111110111011111011111011111111111110111011110111011101222022100102112010112111210111201
1010221201002200121112220121200112121112201200110221111111111011111111001110111011110011110011101111111111111101001111110101011102201020022202221121002211011211
0122201202112001212020222221102012011022201111211221111011010111111101111011101111110110010111111111111011111111111011111111011112010101012122210110112101112110
1011220122102120110022122022210211101110111111011110111111111110001011101111111111111111101111110111111110101010110111010111101111212200011101211100122122211111
1202222210022110112221022002002101111001111011111111010111110111111110110111111101011111111111111101111111011011011101110110111222211021122220221112101121111101
1001112122222221012122012201110211111111101111011110111111111111110111111111111111011101110111110111111110110110011110111110111211122102110212120000122220111101
1212121212122100202012022222211001111100111011011111011011101111001111111100101111111111111111111111110111110011111111111111111021011002121201210110012102201111
1212212212220111002112111201022210011011111111111011011011111101111110101110101111111101111011000000111111111111111111111111001112212120122120020110002020221210
0101111122211122221222021022001201111011110111010110110010111011110011100111001111111111111111000100001111101110111111101111111220221222200212222222210210122001
1201122111212111200021212111222201111011111111111101101110111011112221021121122202112000221021021111011101111111101111011111101221020210202112222222221002022201
1212122110221222201121222202212210011011111101111100111010101011112122121110110022211110111012202111111011011111011111111111110222221120122021222002212101010010
0122121122210020202222121101211100011010101110101111001111011011112122121021112221212111121112121110111101111101111110111111101022122202202022222220022221020211
1111111111111101111101111101111110101111101011011111100101011111100022212211222202212122012201222110120002100222202220211111111222222100002222102222021222121211
1011111111101111111101111101010100011001101011111111101111100110112201221111122201112021022202120212101120211120122102111111011220220221021222221122221222012211
1111111101110010111111011010111101001111111111111111111010111101111221210211010011122101110220110222121221120122202122101110111001210220122022011200202020212211
1100111010011011101010001100111100111101011111101111111111111111011111111020200222210022122222012110200111112212222121111111110202222221020012120022021012122200
0111110001111111100111111111111010100111111011111011111100101100101112211221110121101111222201202200122111100112202122111011011021122212211120101012222222222211
1111111111111111111111111101110111111111101110111101110111111101112100112200121120221212021212021011211100211012022211210111101212222221011210222212022220212211
1111111111110111111111111110011010010111101001101011111111011111102122112211221222021122002222202022221112122201011011110100010220122221220201112221102002110211
1100011101101101111111111111111111111110101111111101011100011111010120121102112120212020222222200222201112112222222022011111111111221110211112220122002121212111
1101011111111011110111111111111101111111111101111010111111111101111111222220201202100010211222212111121100222012012211211011111021120211212110022222212001212211
1111111101111110111110110111111111111101101111111111111110001110111222001112102211112101022222221200111211211221212012011101111022012222121012102001102011220101
0111111111101011111111111110111110010111011110111111101011110011110122111012121112012212012221222101202121201211221021101111011210221210021102121210002222112211
1111111110101100110011111011111111010111111100011110011111110110012112210101110002200110212220022120222221111212200220211111101122001110201212121210002222222201
1101111100111111111111011111011101111110111111110100101011100111101122100122120212221111212222021122122121210001011021110111111111120212011111111122020110122110
0101101111111111111111111101101111101111111111101111111111101111101211210022201211212210122122220021221012120220112210101101111221220012111100202202202210022101
1110111111010110110001101111111100111010011101110111111101101111102201212122110012222022202001220210101012212100111102111111110102111022212012021202121122200111
1111011111010011100011110110110101011001011111111101111111111111111112120120221222112101101121122200120221011110210221110111111122221020021122222201000212021111
1101011101011111111111111111111101010111110001101111001101111110001001002122211210121110222002202110222112022111121221011011110021121120212120212121212222101111
1101111111001001010111111101111111011100111101010111111010111011110220212202000210220112201222112221222121010112022012011111100021002122100112021111011212021201
0111111111111110110111110111101110111110111110011111111111101111102210120120112221201221112202112022121202122220122200211011101210212111122200221101202202102010
0111111111111111111111111110101110111101100001011111110111110011102220212010111211112201121222220211222211211112001121010010101001001121112111010212211012221201
1111111111111111110110110111111110101111111111111001111111110111102011211111211022211201212202222212021210112112021212001001101221110111211101022221122011121111
1110111111110111111110111111111010100111111011001101111111111101102222011122121122111222121211122221122201111011111101110011110221121202102011121121220020111211
0011100111111010111100011111011111111111111010111110111011111011111221201002211122220211202212212211212112121121211101211110111222212211121211220120122221101010
1110111111111011111111111111111010111101111111111111011101001011112010221112102122111221222210221210121221022222202112111111111112222211102112210022212121010001
1110001011111001111101111011100110111111110111110111110110011111011221122222121210011220020012121201022212212112122102201111101210110220210102111121222012122111
1111110011111110011111111111111111111110110101111011111110110111010201122222011122212102120211212212220001012201111202111010101122010222020201112012110210211001
1111110010111111111111011101111110111110111101111111011110111111111111211112122101102222222222221012201122111202102202111101111201120221121101202211221112111111
1101111111011111001111111110111111110111111111101111001101111111112001101111000101202200202202220011002022121212211111001011111111010101111101101111111111101111
1110111011111111011111101111101111011111111101101111101111011111111111111111111110111011011122212121211021222021202122111111110111111111111101011110111011111111
1010010011110111111111011101111110111101110111111100111110111111111111110111111101111111120221011100202021012021211101111101111111111110011111111011111111011010
0111010011111111111111110011111011111111111100111111111101001111111011101111111100110111011021220220222210222102211122101111111110010111111011111111111111111111
1011111011111001011110110111111111100111111011101111011111011111011110111111001010111101111111111111011111011011100011111111011110101110111010111111111110110101
1011111111101111111111110011111111111111011101011111011101101110111111111111110101111110011011010111111110111011110111111111111111101111111111111101011011101111
1111110111111110111110111111111010111101111111101111111101111111111111110110111101110101101111110111101110010111111111111001111100111010101110101101111111101110
1111111110111111001111111111101011111111111111011111111101111111111110101000001110111100011110111101110111111011011101111011101011111110111011111101001011011000
1111111111111111111011110111111111010111111110111011110111110111110111111101111110101011111101111011111001101110111001011111100101011101011101111111000111111110
0110111111010111001101011111011101110010111111011111110101111110111101111111111111111111111111111101011010110111111111111010101010101010111111111110111110111111
1111111111111111111111110011111110110111111010110010110110111101111111111110110011011111011111111111011111110100111110001111101101111010111011111110101111010110
1111110111110111011111101111101101111101111101111101111111111111111111011101100101101111011101111101111110001001011111101110101110111101111110111110111011011111
1111111101110111111111010101111101110111111111001011100111011111111011110111101111110101110101110111110011111010111010101011011110111011111101111111110111111101
1011100110110111111111111101111111111111011101111111101110111110101111111010111111101111111110110111101111111101111111111111111111111011101111111001111111111101
1110101101111111111010111111100111111111010101110101111011111011111011111100111101101111110111111111101101110111111110011111101001011011111111111111111010101111
1111111110101111101111101110111111111101100111111111110001011111011011001111101111101101100010011111111111111111101011110001010010110011110111101111011011011111
1011111111111100010111111011111111111011110101111111111110110111110111111101111101101111101111111111111101011111101101110111011110111111110111101111111111011111
1111101111010111010011011111011111011011000101111011110011101101111111111111111101111011011110111110111111011111111101111110110110011011111110111011011111111111
1011011111111111111111011111101001110111111111111110111111101110111101111111011111111010111111101101101111111101111100011000111111111111111111001011111110111000
1111111010111111111111100111111110111111101101111111010001110111011111011110111111111101101111111111101011110110111111111111101101101011001011111111011111111111
1101101001010101111011111111111111111111101111101101111111011101101111111111001100110110111111111111001111111111111111110111111011100111101000011011110110111111
0111011111100011111101111110110111111111011011110111111011111111011111101111111110011111111100101111111111101100110011110111111111011111101111110101110011110111
1101101110111111001110011112121201120222121002200110101121111000110111001001111111101011010011101111111111111101011011110111111111011011111011101111111110111111
1011111111111111111100111101102121221000212102121122222222001111111111111111111110111111011111111111111111110111011110100111111111010100111110011110111110111110
1101111111011110111110101112201221211111111122211221122102111111111111111011010110101101100110101101110110110110101110111111101110101010110101101101110111111101
1111111111110111111011110011211202122221012222122212211112111010111010101101111111110111101101010011011111101111000111100111110111111111100110111001111111111101
1011111111110111011011111111122221212000211122211002021101111111100111111111111110101111111111011110110111111111111111111111111110110111111100111101011011111111
1000111111111111111110111012210110212011202000122211202011011111101011011111111111001111111011110111101111111101101111111111101110111011101111111111100101101111
1011100011111111110111000102112122120211121112111121110222111111101101111111011111010101011101110011111101001111111111111101101111011101010111111101111011111011
0001011111111110110111110110122111000222122211122221211121110001101111111111111111010101011011011111111111111000111101111111111101111111111111101011101011111001
1111111111110111011101111010221121022120111112212122122122111111101111111110101011111111110111101010101111110111111010001011111111111101110111110111110011110111
1100111100111111111111111012020112210002112211212110111111111101111111111111110101110111111111011011111110111010111111111001111011100111101111111111010111011110
1111001111001111101111111011212110112001201112210122201100110011111111111110011111111111111110011111111111110011011011111011111111111111111011011101111100111011
1111111000111101111101111112012221121222122201221101001011111101110110110111011111111011001110110111111111010111111101011001101111111011111111011111111111111111
0110111110011001111111111111021022122021012022200220112120110101101011110011011010111111111101101101110101100111111011010111011111111001111101111110111101101111
1111000110011111110010111111221021112122201100201122012110011111011111101111101110111110111110101001101111110111111111111111111111011100101101110101010110111110
1111110111100111111111101111011022122202221120120011012222101111100111111100110111110111111110111110001101111011011111101111011101101011101111111100111111011111
0111100110111111110110110111210122221120121222022122012111011111011101011111111110111110111111111111011011100111111001111110110011111110101011110011111010101010
1110110111011110111011111110221111211221121022220212101021111111111011011110011111010110111101111011110111111111011001111110111100110111110110111101110111101111
1011111110101011111111111112112121122212221210212212021222011111110111110011011111111011111111111101110101111111111101100111111001011011111111110111001111111111
1111111100111101111111111111200112212211101220212111211011111111011111111111111101100111111110100101111011101111111111011111101100111111111110111111110111101101
1111111101111111111011111100221122112022120221122202022122111011101111010011011111111100111100101111111101111110010111110111011001111111011111111111111100011111
1001110011000111111110111011212112012021021011211202000201111110110011011110111110111100111111111110111011111101110001111101111111000111011001111111110111111111
1100111011111111011110110010010012012122101112202221112121111011101111111111111111101111101111111111011000011111111011110101111111111111110100110110011110101111
1011101111111011111111111111011021211211120011110120021122111111101011111111111111111000111111111011111101111111011111111111110111110011111101001101011111111111
1110111110100110011011111111110110022212012211211111210001111101111111111001111111111111111011111101111111111111111101111110010111111111001011111011110111001111
1101111111110011010011111112210120200012222102112202202012111011110111111111111011011111111111011010110111110111111101111111111111011111111111111111101101111111
1111101110110101111111111100011211222211011220211220121011111101100110111111001010101110111111111111110011111111110011110101100110110001110111101110010110111110
1011001110110111111011111111001010111222212220102102012020011111011111100111111111111110111111101110110111111111111111111101011111011111111111101111011111111111
1111111111101111111011011101111101120211022212211220021212110111111110100110111111111101111111011010110111111011111101110011111111111011100101110010111010001100
1111011101111111111011111102202220122222111021011212221212111111111101111011110110101111110001111111110011110111111111111100101111011101111111111110111111111111
