7 145
116 4
113 71
50 121
16 103
48 134
5 27
47 58
7 149
45 72
011111011111120101122210211220112212201000211111111110100100111010111111100110111101111011011110111111110011a011011111000111a11111111122001012201211011222102012
111111111111122201210122012101220101001002200111111111111111101111001011111110111111111111101212111110002222b212122101111011a10011001122211210212110111112101010
111101111110012021002202121000012120001020111111110111110111111111111110011111011110101112210121012102211102b102121121210111a11101101101201122220220210012122222
101101011111111112122201002001100002212012211010111111010111011101110011110111111011011121222122121121112001a110002212211111a11111111102211021120111102211002120
111110100111121120221111211011122222012112211011111111111011011101111111111111111101011122202122112111012112a220212121200101a11111101112112201211222011012212021
111111111101212021102121201122101022222021201111110101111101101111101111111101010110011102111010102210110100a112200110211100a11101111021201100222000211212110202
111111111101112111022021211020100010222100201110101110011110100111011101111001010111011122121222210122102022b220200201101111a11110110121121021120121222011010112
111100011111102202112201011011010211012011011100111001111111111001111111111101111111111122020002211111011012a001112100211011a11101111102212120022221101222111111
010111111111122220221111211121121222022111211110010111110111101101110111101111111111011111022122212222010222b121222011210110a11011111001120101112121110221211111
011111011111012022221022201011111101022211211111111111111111111111111101111011111111111110222111011112121112b111122112211101a10001100121121202020201222002022001
111111111000221212210211112112121221000121211111111110111101101110111111110110111111111122122010111222112122b220022111111111a10000111121111022110022212122222102
011011111100101110111121001222002101201001211001111111001011111111111110111111111111111120120221220222121200b212122112211111a01111111100211210222122000100211200
011111111110111021212102112121120222102122211111111101110011101111101101101110011111111122022212102022211012a220122221211011a01011110111022121222202122102011121
aaaaaaaaaaaabbbbabbbbaaaaaabbbbbbabbbaab12201101111111010111111111011111101100011110011110111011212010101121b022121121111111a01111101121122102101210010122211022
111111111111222121020211111111212120212b11011110111111101101111111011111100111101011100122022112201010202221b112001100111010a11101111121110211021200011202212210
111101101110220222010102221022011120220b11011111111111111111101101100010100011110001111021122222220111200122a010122110211111a11011111010221210211012221122201110
110011110111012221101002021021221012221b01200110110111111001011101111111101011110101001112121220102021112011a122122111110011a11110011102112021202111010201222002
110111111111121212220222121211121200212b21101111010111110111110110111011011111111011111120200011012200022021b221101102101111a11111011100201122220100201222010202
111111111101101222202222011121210100102a21011111111011001111110111101011111101110111111101112112101111021112a211221211110101a01110110112021121101011120200012221
111011111111101122102022222211112202110a21111111111111110111111011100111111111111111111120211211220102222222a110211110011111a01011101121202222221221121011221201
001111100111120021222022021201120221222a01001111001110110111111011111101111101011111101102122212212220011201b211210222111110a01101011122200220222111211210202201
111111100011100111010111111011011011111a10011111100111101111100101111111111111101111111121201200222221022002b010212010211111a10110111101012202111122012211022111
001111111011111111111110001001101011101a10110010011110010011111111111110011111110110111000022112210111211112a110220022210111a10111111111000211010211120222020121
111100101100011111011111111010011111011a10010110111101111111111111011111110111101111101122011111110211012020b122210122011111a11111111111111111001111101111101011
101111100111110010011111100111101101011a10110110111101111111111110101101111111111111011122211220100210210111a202221211211111a11111011111110101011011101111111111
001110100111111111011111110011100101110a11110111011111111110111111011111110111111111111122222221020010120120a011012201111111a10011011111111011111111111111111110
101001111111111001001110111011111110101a10011111110011011111111111101111111111100110101101101012112212221101b011102110111011a11110011101111011111101111111101111
111111111010111111101111111101110101101a11111111111111111011111101111101011111110111111122120112222221211212a200002002211111a01111111111101111011011111111111111
111101111001011101111011111111110111100a01011011111101111011101111110111111100111111011012021112021211211021b210121222211111a10111111111011101111011111101111111
111110111001011101111010111111011111111a00011101011111011110101111111011111111111011001112222221110102211112a222212001001011a11111111011000111111111111110111110
111110111110111011101111111010111111111a11001101011111011111202112012122112022201110112021101020110222020221a210210212011111a10101111110101111111011110111111010
001110101111110110101101111101011111101a11111110111110111122212021111211121111221212111120221210111211222111b111210211111111a01101111011111011111101010111110111
101010110100011100101011101001011011001a01111211200201122210102200101020021121120111210211111111011111001111a111110110111111a11101111110110110111111111111111111
111001111111111101111011111111101110111a11110121011220100000202022221220022021221222020111111111110101111111a111111111112011b01211120121220211021102201011111011
111111111111110101101101111100111111101a11112111111221121210222022022202011211102121121210111111110111111111a111001111111121a22110122102021010102220221111110111
110011111111111011110111101110101110111a11101110211211121201111102022202211221212020222110101111111110101100b210101001102112a22220122002210221100211001111010110
111111111101111101111111101111111110110a10122222202222222202200022022222111121112221020111111110111111111010a101220021200120a20212222222101220122222111111111010
100011011111111101111100011110011011101a00101121111112201222222212222222212021012112101111110111011111001110a212012101222222a12022212222200202022121221011101101
100001111111010101010110110011111111111a11121021210212211220221120021210222102212222111211111110111111111102a111221102222022b20222000220212222221101110111110011
011111011011111111111111111111011010001a11111220112121012022012222220202120211111202222211111111101111111122a112220010112222b22201202220011021020112221111101101
110100111111111000110011101011111011111a11110110212012012222210222222010202122122101122211101111101101001110b122102211002121b22222122222210212211111000111110111
111011101111111111010111011001100101111a10010200100111211020020121202211222011120011010101110111111001101110b221000012222222b22022012220222112010212111110111111
111111111111111100110111101110111111011a10012200011101221202222002212220112002222122221201110001111111101112b202211000112211b11222022200212220120210111111111111
110111111111011011101111011011111111110a00120211002221022222211120202001122222122202212110111110001011001110a210212210022022b12222022122221112102221221111110111
111111010011111011011111110111111110001a01122211122002202020022122000221200121112210201010111111110111011101a112121111222002b12221210220202221122011011110011110
110101111111111011111111101111111110111a11111011200120110022102112120221220100110220100101111111110111101112b112220211221121b21221122202212201112111111101111110
111111111100011111111111110110111111101a11112212202000210021201022222012220200122011121011111111111010111022a121212121222221a22202112202220122012222100111111110
111111101101111111111110101111011110110a11021122221211111200001222210112221100001121220111110111001100011111b120121212211222b22021022221021110222121211111110111
111111111111011011111110111110111110110a11111121112011112012122201022222202211001100122011101111101101101111a212102011021222b12222222200112121111012010101111101
001111110111110111101101111011111100111a00102212112102001220220202202222121111102222111211111011111111000111a010212222122020b22221221222221212222011211111111111
111101100111110111111101111110101101111a10111101212100222221120222022112012202112121211110111111011101111121b222222011122222b20212202211222010121211210101101111
011111110111101101111110111111101111111a11111222200121102222202220200221212101221022122111111001111111110122a212121220210122b00112212022011220212001021111111111
001111111101111011111111111111101111011a11121211211021122200222112212011211022210121211011011110111111100122a202222212102000a02022012220222121222112120111011010
011111111101011101111101111101110011100a10122102122102221020000222222002221110120001210111001011100011011102b022201122222201b22220210211212210111122110111111110
111111111111011101101111101110100100101a10121022122201112110022102222022201122101020022110111001110011110111a011101222221220b22202220222120102212210221111101101
111110011111110111111011101110111111011a11111112110011101112222020121222221112202211222001111011110011111112b112102010212220b21220122122222001211222111101101110
111101100101101100111111110111011110111a11110222111021122201221222002020202111111221122110111110101111101122b201221022020022a11212220022222121101122121111111111
101111111011111101111111110111111110011a11022121221201102202212002000220221000221012221100111101101111110101b112121000122022b20002222002220212102211101110110111
111011101111111110111111111111011100111a11101120202201201222222120221221220201022211221210111101111111110012b110010202210020a22122220202222121011120121101111011
111111010111011111111111111110101111011a00111120112102210022222120220021020222211201222011010011000011111120b021112011102112a22021022000211212000220221111111111
111110111010111100101111110111111101111a01121222210121002102022221222220222122022122112211111101100111111111b222111211121022b22220101220122220022022221111101011
011110111110001111111111110010111111111a11121110122221122211221221002121110111111011111110111110010111110022b102012022200020a22120222022220111011222001110011111
111010101111111101101100111111111111011a11121121102021221022122022220210111111111101111011110011111111101100a120011200101222b22220022201200001122122200111111111
101101111110110111110111010010111111111a11111100110111111111100111111111101111101111111111100110010101111120a121121212202020b22011220211221020122101211101110011
110111111001110111101111111111011100011a11111111111001111111011101111111111111111111010111111111111011111122a221210210010022b12110221121211011111110110110110011
111111111010011101111101111111111000111a11010011111001010111000111101101111111011111111100100111111011111122a222120221112221a20222101222010110001011111111011111
111111111111111011101011001110010110101a11111111111111101111110111111110011101110111111110111111101001111111a111111100011111a11111111111111101011111110111110111
111111111101101111111011111111001111101a10111111111111011111111111111111111110101101111101111011111101101111a110001110111001a11111110111111111101111011111011101
111110111111110110111111111111101010001a10111111110111111011101111111111111111111011101011110110101110101100a011111101010110a11111111111110110111111110111011111
101011101111101011111001111110111111111a11011111101111111001101111111111111011011110101101001101111111111111a110010111110110a11110011111111111111111111101111111
111111010111110100111111001111111111101a01111011100110110110111111111111010111010110111111111100001110101101a011101101111011a11111111111111111111010111101110100
111101100101100011111110111101111111111a10111111011111111111011110111101111111111111110110111111000111101101a111111111111111a11111111111111111111011110111011111
110111111111111010110010101111111101111a11101111111011111110100010111110111011111111000111111001110101101111a011101111111110a11011111111010111111011111111111001
111111011111110111100111101101100110101a11011111111111101011110011101111111011101111111110101011011111111111a111011111111111a11111111101111111001111111111011111
011101100110110111111110111101101001101a01111111011111111111110110111111011111111111111110111110011111001111a101101011110111a11111110010111111000110111111101111
101111011111111111111111110111111111100a11111010111010110111101111111011111111111011100011101111111111111011a000111111011101a11111001110111010111111111111101111
111111110101001010110011111011011111111a10000110111111111111111101011111010110110110010101111111111011111100a011111111101110a11111111111111111101110100100101111
111011101011111011010010101011111101110a11110010011100110111101110111111111011110111011111110100011101111111a111111111100110a11111111100101101001100101111011111
111111011111101000101111011111111001010a11010110011110111111101111111111110101101111111111011011111011111111a011001111111110a11101111011011011111110101110101111
011110101101111111111111111111111111111a11110101111111110111011101101111111101111111110111101111101111111011a111101101101010aaaaaaaaaaaaaaaaaaaaaaaaaaaaaaaaaaaa
101111111111111110111111000111111001010a01101101101011011101101111111110011011111101011111111111001111011110a111111111100011111111111110111111111011010010111111
110111101111001111111010111111110110111a11110111111101111111111111111010111100111111101111111011011111111111a111101010110111000111111111111111111110111111111111
101101111111001111011111101111111110111a11111111110100011000111111111101000111111110011010111110010011110111a011111111111010111011110110111111111011111111011101
010110111010111110101111110110111110111a11111110011111101111011101111110110111111111101010110111100011111111a011101111111111111111101111111101001110111011111101
101011011111011111111011011101110100111a10011111101111111010011011001111110111111110111100110011111111110011a100101111110011001111011111111010110111111110111001
010011010001111111111111101111111111110a11111010111001011111111010110100101101111111111110001000110011111111a111111111101101110111101101001111111101110111111110
110111111111111100111111110111101111110a11111011110111111101110111111111110111011111111011111011111011111111a111100101111111101010111111111111111111111110101111
111111101001100011011111111011110111111a11000110011111111111011110111111010111111110101111111101001010110111a111101111101110110111111101111110111110110110110111
011011111111111011110111011111011110111a11111111111010011110001111110111111111111111111011111101110111111011a101111111101000011111111111111111111111101111011101
110111111111111111111111000100101111010a11110101111111110111110111111000111111110110011111111111101111110011a111110000111110010011111111101110111111111110111101
100111111001111111101111101110010111010a00101111110110111101101011111011011111111111000111111011111111111111a111111101011111101011101111111111111111111111111100
101111010010101111111111011011111011110a00000111110001111110111110111111111110111011111111100111111010011011a111111010110011011111011101110011001101011110111111
111111110011010110111111101111110101011a10011110101110001111010111101011111101011111111110110111101101111111a111011101011110100011011111111011010101100011011111
1111101111111011111aaaaaaaaaaaaaaaaaaaaa11111111111111011110111111111111111110111110111111111111110011111001a111111111100110111110110011011011101111111111011011
1111111111000011110a1011111110111111011111101111111111110101111111111011111101111001101111111111011011111111a110011110111001011111100011111110101111011111001011
1111101011110010111a1111101111011111111110111111111111111011111110011111111001111111010101111101111111110100a111100110111111011011111110111111111100111011111110
1111111101111011111a0111101111000111111111111111101111111111111110011111111111111111110111110111011111011110a111100111111011101110101111110111011001111111111111
1111011111111111111a1111010111110111111111011111111111001111111100111100111111111010101101011111111110111110a111100111111110111110101111111011001111111111011011
0111101110011101101a1111011101101111111111010111111101012202012100220012000112222021111101111111101111101111a111111111100111111110110011111110111110010011111111
1111011100111111011a1110111111111111111111011101aaaaaaaabbbbabaaabbbbbbbaaabbabbabaabaaaaaaaaaaaaaaaaaaaaaaaa111011111100111101110111111111110000101011110100111
1111110101111110111a1011111011001111111111111111a11101102111baabbabbabbabbbbbbbbaaaabbaaaaaaaaaaaaaaaaaaaaaaaaaaaaaaaaaaaaaaaaaaaaaaaaaaaaaaaaaaaaaaaaaaaaaaaaaa
0101110111011011111a1111111101111111111011110111a11110112211b221111221212220202102211211111101110111101011011110111110110101011110011110111001101101101101111101
1111111111111100101a1101011110111010110111111011a11001111111b112120221210022112101021011111001111101101111111110111001101101101110011101011111111111011100111111
0111111111101101111a1011011111111101001110001111a11001111112b122222112111201010111001120110011100001111111111111111111100011111111111111111110111001101111111101
1111111111111011111a0100111000010110111101011111a11111011220a022012121221101121222112121110111111111101110011111110111101111111111111111101111111110111111110110
1110111001111111111a1111111101111111011111111111a01111011220a111010202112022202110002121111111111110111101111111111111111111111101011111010111111011001111111011
1100111110011111111a1011110110111111111110111001a10101111102b221100221222112122011111221111111111101111011111111111011000111101100111111110011111011010111110011
1011011111111111100a1111100011111101111101111111a11010102220a022201202121221012112222221111011111111101100001011101011111111111110111010000101011111111101111010
1110011111111101111a1111100111101110100111111111a11101011121a201100121211102110222201121011111101110100111011110101111111101111001111010111101111010111101111111
1001111111101111011a0111011011111110111111111111a11111010202a102202120012212222201101121111111111111111111011111001111011110111110111110111101111111111101110111
1111011111010110111a1111110111011111111101111111a01111111212a220012221001220111202012011111101111010110111111011110111111111111001100111111110101111101100111111
1101011101111011100a1110010111111011111101011111a01111110012a122222222212210111111012121111111111011100101101100110111011001111111111111010111110111000111111111
0011111111011101111a0111111111011111110111101111a11101012220b211222112012201220110220211111100110101111111101011001111111101110101111111111010111111111110111101
aaaaaaaaaaaaaaaaaaaa1101110111101111111101111011a11001010121a121202112202212112111120121011110111111010011101111111111010111110110011111110111001111100100111001
110100111011110111110101101000011110111111001101a11111100021b021220122221111212210221121111011111010111111110110111111001101110111111111111111111111111111011110
001111111011110011111101111110111101111111111111a11111112221b211222212201112211122222021011110101111011111111011111011111111111011110110111111101111111111111111
111110111111111111101011111111001110100000011101a01111100011a012122212102001100120122111101111110001111111110110100111101110111000111111101100001111011111111111
001011110111111101000111111011111101111011101111a11011012001a021122120112200211111222121011001111111001010110111111111100111111011011111011111111111011111111001
000111111111111110011111110011011001111111001111a10101112112b021122211010021111211221021110011111111111111111111101111111111110101111111100111110110101111011010
0111111011111010101111101011aaaaaaaaaaaaaaaaaaaaa01110111101a221121020222121101212101221111111011110111011111110111111100110110111111101110110111111111101111011
