16 9
10 156
69 11
45 102
86 47
53 53
4 82
90 106
80 118
85 8
11111011111111110111101011101111111111111011110110111110111110110111111221122101222111200211102012111111010110111111111a011111011001101111101111111011010110101a
01111111001111011011111101111111110110111111111111100111100011101110120212012222222112002212121112111101110011110111111a011111011110101111111101111111111111111a
11110111111011011110111011011101111011111101111111111101111100011110112201111222101022101022112022110010111101111111111a111011101110111110111101111111111111110a
11111011111010110111010001111111111111110110111101010101110110111111211221112100221122122111112221111111010111111111111a101101111101111011111101111101110011111a
11110010110111001001110001101011111101111111111110111111111111111112020101201111122021211111112102111011101111101111111a101000001101111111111111111110111010111a
10111110111111111111111111000011101011111110100111101010011110111110221120222202121111220202120221011101111111101110111a110110111111111010110011111111111111111a
aaaaaaaaaaaaaaaaaaaaaaaaaaaaaaaaaaaaaaaaaaaaaaaaaaaaaaaaaaaaaaaaaaaaaaabbaabbaabbbbaababbbbabbaaaaaaaaaaaaaaaaaaaaaaaaaa011110110100011110101110111111101111011a
101111011010111111111111111111111011111010111011110110111111111111121211221102001112122112212220110110001111010111111111011111010111101001111110011111110101111a
111110111000011111111111111111111011101100110011111111111011011101111222221101102001211001221012111110111111111111111110101111101101101111101111111111111111111a
111111011011111111111001111111011111111110111111101101111111111010101212121222022021022222221012101110010111111100111111111111111111111111111001111011111011000a
110111111111111101111111111110110111111011111111111111111111011001121211210111020212222110210211110101111111111111001011101111101111110001111111111111110110111a
110111111111110111110011110001110101011010111011101111011111011011112021012001011022120022222202201011111111111101011110111111111111110101111111111010001011011a
111111001111111101101101111111111111111101111101101110111111011111102000011012211122121201220121021101111011111011101111111111101101111111011110111011111111110a
010111111111111111111011011100110011111111111111111111101011111001121221221122011201010212121022221011111111111111110111011111111110101101101111111111110111010a
111111011001101110101111111111111110011110010111111110111111111111111022210020222220101212000122201110111111111111111111111111111001011111110011011111110111111a
110111101111111111100110111011011101111111111111011001111011011111112101121112222220210001111011220101010111110110010011111101111101111101010101011111110110111a
111011111100110111111110101111101111111001010100111100101101101111111111102102112122211112221210120101101110001111110111101111001110010000100111110111010111110a
101111111111111011010110111011100011110110111000111111111101001010012021121211021212202200212122221001100011101111111111111111110101101101110011011111110101101a
111110011100111111111111011001011111111111110111001111111111111011120211112212202020112212222121121111111111010011110101011000111001111110110010011101010011101a
111101111111111111010111111111000111011011101111111111011011111111120110101121012010222221210212221000101100111110111111011101011111111010011011111110101010001a
001011011100111111111111111111010111111010111011111101100101111111111101101100111011101011111011111110101010111000111101111110011111100010110111001111111111111a
111001111111001101111101111111111111111111111010100011110011111101011111000111011011111111111001111111110111101110111111111111011110111101111011110111110111010a
110111101111101111111111111111101111101111111111110011111111111111101101111000011011011110111111011111111011111111111101111011111110111011010111111111111101111a
011001101101001011011101111000101011111111011111101111101110011010100100011101111011111111111111011110111111111101111011011111111101101110101111000111101111001a
111100011111111010100110111111101111111110111111111111111011011111101110011111010101111111110001111111011111111001001111111111110100111101110011111111101101111a
aaaaaaaaaaaaaaaaaaaaaaaaaaaaaaaaaaaaaaaaaaaaaaaaaaaaaaaaaaaaaaaaaaaaaaaaaaaaaaaaaaaaaaaaaaaaaaaaaaaaaaaaaaaaaaaaaaaaaaaaaaaaaaaaaaaaaaaaaaaaaaaaaaaaaaaaaaaaaaaa
0111110111000111111001111111010111110111011111111111110111110110000110111111110110000110111111101111111101011110110111111111101111111111111111110111111111111001
0101111101111110111011101110111111111111111011111111111111111110111011001111011111111110111111111111111011111111110111111101101111110111101111111111110011111111
1010011110111110011111111110101101101101111111111001101101111100101110111110111110111111111111111111001011101111111111111001111101101001101001101111111011010111
aaaaaaaaaaaaaaaaaaaaaaaaaaaaaaaaaaaaaaaaaaaaaaaaaaaaaaaaaaaaa011111011111111011011110011110101001110111111110111011110111111111111111011101111111011110101111001
111111111111111101011011111111111010111000101111111010111111a111001111111110011111101102202202002020122212220122100101011111111111010111111101111111111111111111
011111111011110111111111110111111110111111110011111111111111a010111111110101111110001112012111220210021112010222022021111111101111110001111111111111111110111111
110111111111111111110011111111111011111111111001111011010111a101101111111111111011111111212210101222020012122111122221111000111100111110110111010011101010101101
111001111111111011100111111111101111101111111111111110111101a011011111101110000111111010000011112100112010201022000222111111111110111111111101110111111001010110
011111111111011111101000110111101111111010110100101111111111a111011011101110111011010110002212122112122121200000101221111010111100111111100111110111111110110111
111111111110100110111011101100101011111101111111111011110111a111011111010111010101111001021210112200211011102212012010111111011111000111111110101111101111110101
111111111111111110110110001111011011111111111110011111111100a111111100110111111110011111122121222122102101201212222201111101111111111111111110111101111111111111
111101111101111101101111100111101011110101101101111101000111a111111100111110101110111111110222212222001221222212111222111101011011010111111111100101111111111111
011111011111100111011100110101111111011200202220212212202211a100211221111111111110111112211210220000211020222210212122111110011110111110000111010010111111111001
111111011110101101011101000011011111011120122111211202212020a222201201110110111111010012222101110120210212221212001021111010011111111110111100100111011100111111
110110111111111111111101011111101111101110211200201222201222a120222021111011111111101011201021111212202120021010020212111011011011111110111111111111001001101111
111111111111111100111111010111011110110222112010212200222021a121221110111101111111011101222101111111212021001221222212111111111101011111110011111110110111101011
110100111111111110111101111111111111110220212121222111110201a001000220110111110111111111012211102021011002212221110111100111111101111011100110111110101001111111
111110111101110111111111111111011111002112211212111112001111a122221111101111101111110102022122021222121112222101012102101111111111111001111111101111010010111101
101011010001110111111110111101011110112020220022011022001111b121021211011111111111001011211112210020121102201222022202110111111100110101011111011110110011111111
111111110011010111111101101111110100110111002012222221122222b212122121011111111111101011212011211111120002001222122021111111111110001011111111011111111101110111
011111111110111010111100010001011110012120121110210212011122b201222121111111111110111101221212121202220112121100111222110110011001111101001101011111111111100011
111110111111111111111111111101111111011100211102011121212211b021111201111011111011110110201011220111122110210002210121011111011011111110111111111111101011111110
111111110011101001011111110101001111111110221102121002111121a210101210111111111111111111222122201100222110222002210022011111111111111111111111111111100111011110
101101111011011011111101111111111010112211121202212102212112a211120001111110100010110111112011212020220111201002021100111111101111111001111111111111111001011101
010010011111110111111111111111011101011221211212122010212110b121100121111111010010111112201211210102222112101101101121111110101101110111111111111110110010010011
110110111011011111010011110111110111110212110220221222021211a111221121111010111111101111222212021010021022111122201000111011101111111110110111111111111111011110
111111100110111111110110110111111000110222201012222221110200a011022121111110011111110112111112110200001020201211120011111111101111111111111111110111001011010101
101100101111111110110110111101111011102002201200121121012211b121200211011110110110101111221000220222001121101110201122011111111110111111111111111010110111111011
121202221122101210221021210111001111111012211012102211122112a212021120111111011111100112122122112011112002212002211101111101111101111111111111011111111111111111
202112211001012101221102111111010111111121110120201211112211b120111110110011011110110101101221122021221121112112211221011111011100101111101011111111111110101111
221212222100210211110000202111001111111021222212220010001120b011210101111111011111111001000022001210220212212222101120111101111101111111000111111111101111110111
111222101212212122012221122010101111102012212121200112110222a212222110011101111111101112011211122112222102212222121001111111111010110111100111110011011101011011
021102210122102221122102211111111111102121112221112111020202a112211221111011101001101012022021011120112111111221010210011111011111110111110111011111111111110011
202211122002122100211221212111101111011112001012212211122210b121000110111011111111011012202201000222222201000021111220110111111101011111111111001101111111111111
122010101122122021120002212111101111110211111221111222121122b121101121111111111101001110210221010211122112112111120002111111110111101111111111111111111001111110
111121220102220221112111111110110111012222000002001122200221a012220221011110111110111111111101111111001111010011101011111001000111111111011101110111110111111111
211101011110121020210221122110101100111221210211222220212211a122210121111110011111110101111111000001011111011111111111001011111101111101110110101101011111111001
220211122220221011120212121101111111112012002022101200112120a101211020001111011111111101111111110110011111101110011011111011111011001110111111110110010111111111
112122120111101120121100020011111101012210022020210222121200b120120210111111111110101100110111110110111110110010111011110111101111010110111111110111111111001011
211122212221112221100202122100101101012212111221012102220210b120211001111111011111111111111111101111101112002101210111221111111021221211111111111111011110101110
221201211222002222210202222111011101110222000201112201021122a022022211111111110011011111111011100111011211112112211212002122222221202211110010011111011100110010
211021110102012012212110011110111110111012202121222202212102a222022111010111011111111011111101101011111122202220211011220001022212012111101101110111111111010111
222222222102022020210201022011011111112101120010112110122222a102010021110110011110111111011110110111111122121122010221100102221121111010111111111000011011001111
babaaaaaababbbaaababbbbaaaaaaaaaaaaaaaaa11110100110100101010a111011101110111001101100111111111000111111200001210001021011221020200222210101111011101111101011111
021222212220202222120222111001101111111a11111100111010011110a101011111111111110111111011111111111101101101111211102211220121102112122011110011101110111110111101
022120012221220111221222101111102100100b20221222011202121021a101100011111111011000101111111111101101111022220122100000011202122011120211011110110111011111110011
212112112211012222122022221001111221022a12222111021202201112b011011101111110101110111101101110111011111101202211110210112201122211100211111111110011101011100111
122022212221122202222222112010112212121a12201122001120120210b220111111111011111101011111111011101101011221200021122212212022202221111100110110110111111110111011
022222221202002221202221100111000211120a10012011212211210212a121111011001110101110111111101011111111011000202220012212212111111211112011101111110011011011101101
222210220210220101220220212111111201112b01222120200121220110b111001111111101011110011101111222122200120201122221122002212220121112202211111111111111111100111100
111222222212222222022222212111111010222b22001120112210222211b210011011110011111111111101100110210111222122212001112122222122211112200211100111101110110111110011
222222202000222022212202210001112102011a21210122222011211212a110111000111101111111111111111222002211222002220220221221001021002111221211111111111111101001111111
112221212012122220022202112111111201111b10221011112102110220b121110011111111110111111011111011122111221222220221221222222102102110012111111110111111111110111111
001122212200202222200102212110111012202b00212001111202112122b221111111111111111111111001111122002122101222212222222211122212222100220201011101111111111111111101
202212121220212022122220221011110202221b22212221200222121122a211111010111110111010101011101120121110021212222222122122200121121212121211111111011011110100011011
222212011111220211210022222010102122201a12222201122221022011b111111011111101111111110101111112011112121222022120221220022201021120122111010111111111100111111101
121020222202210122201222201101101012022a12211122012212212002a200110111111010111111111111111011121002201222202001202122210222222002002111110111011111110101111111
122112122212012222221220002001102221020a02110112220211212121a110101111101101101110010001011112222011012201222122222200112202111201220111111011111101111111111010
222210221011022221210222220111112221211b01122211110112111101b220110111110101011101011110101022220122112212112102210120221211021221111211010111101111111111010111
211212211221221212200211011011011000111a11102212012110000222b100111110101101111111111011111111020212211211212222222222222021122111011010111100101001111010110111
011211200201122112212221101111012112010b01112011202210111100b221101110110111001111111110111120022001200022202020212212022011122220222011111100111010111111001111
100121202222011111111122111111101112111b12121122111211102222a211111111111111111011101011111222002111222210222222122222222221012101112211110111111100111111010111
122120100211022202222211010001102021211a21112110220122102012b020101111111111111111111111110220120110212211022112222122220202212110011211111111101011110011111110
012121020011220220222111101101112121222a20020221101122120221bbbaaaaaaaaaaaaaaaaaaaaaaaaaaaabbbbaaabbabbabababbaaabbbbbbabbaabbaabbabbbaaaaaaaaaaaaaaaaaaaaaaaaaa
022021201121201212110212111111011111222a120011211012210101112110100101101111010111111111111111221202021120201120222220010102120112101101111011111111100100111111
200222121102211221211221110111111202221a000222001121210111221111011001111011111111011110101012221221101222201022222222112021212211201101001101111011110111011101
112001201122221211221121101111102212121a020210202111112211111120000110101110111111111111111012021222221202222122222121221022011210122101111111110011111111111011
110211121101112211222210111111112221112b102211111120111111111210100111111111111111111100110212112002112201000020222100022221112222222110101011100111111111101010
202112202222102012111211010011110120212a122221121211200111222211001011111111010110111111111121112122012101122122222220222222010222022110111111101110111010110111
222022121201011111021211111111110111120b002012102221012121022211101111111110000111111111011221020111211222121220022022022122201211211011100011101111000111001111
202112222211122222121012101101111202021b221012210020211011221221111111101011011100010110111110122221011020122021102012201201101101110111111111101101111111101011
122122101211222120212120111110112212112a121002210000222211200111111111100111111111010111011220121002122201102210001012222001011011001011111010010011111101111111
212102112212212112001122111111012121210b111120021211212102222111111010111110110111111011101022001222111211122221111111021100111111110101111101111111101111110110
120111112201021002120221011111112111211b012210201111101112211211111111110111111011111111111210212200121112211212222111210210101011110101110110011110110101110011
210021120220120120001211001011111111111a220121011110021222021111111111011100101111111111111020122112220112112111102201220111011011100100011011001111110100111110
110111011010111111111111111111112022112b121122211121101221022221001111111111111101111111111112100112021010212222211121201111111101100111101010111001110111101110
111111111111111111110111111111111111110a110101111011111110011111111101011111111111110010111122011210110112222101122110111100011111111110111011111110111111111100
010001100111100111101010111111111010010a110100110011110111111111110110111101100011101001111211222020211011221200111211222211111010101110110111101101011111011011
101111101111111110111110111111101111111a011111011111110011001011111110111101101011100101111222020011212111110121222222212211111111111111111011111110110101011111
110111011101111101111111100111111111101a110111111101110111110101111011101111111111111100111120212002111122211101111021102111111111101111011111111011101111111111
010100011101110011011110101110111010111a111110110111011110111111101011110111111011111111100100111111111111111010101011111111111011101111111111110111001011111110
111101101011111111110101001100011111010a100110111111111111111111111011111011111111110111111011111111111101110111111001111111111111111110011111101110111010011111
111111110101111111111101111111111011111a010001011011111001011101110111111101111111101111111001001111011101011111111101101111111010000111110111101111011100111101
aaaaaaaaaaaaaaaaaaaaaaaaaaaaaaaaaaaaaaaa111011101101111111101111111111111010110110001110101111111011110011111101101111010111101111111111111110111100111111100111
0111011011111011011011011101111111011111001011110111111110111011111111111110100111111111111101110111111101111111110101111111111111100110111111100110001101001111
1010111111111111101111010111101111111111101110111111111001110111110111111111111001111111101001101111111111110111101010101111100111111110111111111110111111001110
0101111111111011111101011010111110101101111011101111111100110100110110101001010111000101111111111111111010100101111111111111111111110111111111111101011101111111
1111011000111110101101111111101011111101010101101111011111101010111101111111111011111111110111001111111101111111111110111100110011111101111010111111110101111110
1101111111111111010011111100111101101111111111001110110111011010110011111110011011111111011111111111111011101111111111111111011101111010111111110111111111111111
1110110111111111110101111110010110111111111011011111110001011111111111111110101111110110011101111111111011101111110111111001110100111100111010111101101010110111
1111011111111011111111011111111011001011111110111101011011111111111011011111111011111111110011111111111101111111001001011010111111111110110111111111010110011111
0111001011110110011111111111111100010011111111001111101111011111111111111101111111111111000111011111111101111111111010110011111100111001111110011011111101101111
1101010111111100111111011111111110010101100111010111111111101011110111111110011011111101011011011101111101111111101101111011111111101111111011111111011101101111
1011111011111111111111011110101111110111111111111111111111100110111011111011010011011111111101111111100101100111100011111100110101010111010001111111111111111101
