117 11
17 159
87 50
63 45
97 98
82 143
72 65
38 7
104 59
106 28
0011111111110111111111101111111111111110111101101111111111011011111111001110111101111011111111111000011111111111111110111100101011101111010011111011010111101101
1101111111111011111111110101110111110001110111111101111101111111010110111111111110111111111111011101111111111111111111110111001111111110111111100110111111110111
1111111110110111011111111101101111111111111110100111101011111111110011111111110111111110110110111010011111011111110111111010010101111111111101101111111111101110
0111011011011111110101111101101111110010101011111101110110001110111111110111111001111111110111111111110101101111101110111110011111101111111111111101111111111001
1001111111111111111101011100111111111110111011111011101011010011100101111101101111111101111001111010101101111111110001111110111101000111110001111101101100111101
1001111101111100111101111101110111111111110001111011011111110111111111100110111111011111111111101101101111011010111111110111110011101101101111101010110111111101
1010111000111100111101111111101111111100011111111011111111111010100101111111101010111111111010111010001111111111110110111111011111111111111111111110111111110111
1101111111110110011111111011111111111101111111111111011111111110010101111101111011110011111010101111111111111111111111111101111111111111110111000011111110001111
1011111011111110111111111111101011111011111010011111101111110111011111111111110001110111111101111111111101111110110101110111111101101101111011111111100101010111
1111101111101111011111011110011111111111110111111111111011110111111110111101101111111110011111111111110111100111101011110110111101111011111001111001111111111111
1011110111111110111111010110111101111111101111011010111111111111111111111010011011101001101111101111101101111101111110111001101001111111101101111101111011111111
1111111111101011010111011111111110111011111110111011110111111101001010001110111011101111011011111101111111011111011101110110001011111111110111101110111101111101
1111111101110111111101111110111111111011111010011101111101110111011111111101001000110101111011110110111111101101110111100111101010110010011011100011100111101111
1111111111110011111111111011101111101101101111011111011011011101111111111001110111111110101111111111111110001111111110101111100111111011001111110011111111001011
1011101101111101011111110111101011111010111101111111111101111110101101111111111011111100101011111111111111101100111100111101101011110111011111111011111000111111
1011111000101111111011110111111111111111101111101111111111101111111111101111101011111111111101110111111011111111111111111111111111011111110010011111111111111111
0110011010110101001111111110101111110111110111111011111110111111111111111101111011101111101010111001101111001111110110010011111010111100100111111010110111111011
0111111011111011100111010101111111111101111011111110111110111011011011001110111011111111010111111001101010111011111010111110111111111111010111111010101111111101
1111101111111111011111111101111111111101111111111111111110111001101011100101111110110011011111110111001111111001111111111011101111101100110111010111111101111100
1111111101011111110111111111111011001011001111110111010110111011010111010101111011011110111110011111111111111010100101111111111111111101111011011111001011101101
1101111111101101101101111111111111100111011111111111111101110111101111111001110111111111110001100111111011111111101011111111111111110111111111111111101111111101
1111011011111001111110111111111001101111101011111111111101111111011111110101100001001110011111111101110111111111011111111010000111111101111111010101111011110010
1011111111111101011111111100101000101111111011111111111110011010111100101011111101000101110111011111101111110111111111110111110011011001111111110110111111111111
1121120022001201211101111111111111111110111111111111111101111110111101100111111110111111001000011111111111001101111110111011111111111111111011110110011111111011
0121001121122011211112211111101111110010010111111110101111110111111111111111110010111100001100011011001011101101011111011101101101110110101110010111111110011111
1011001210122221112022211111111111111111111111110010110111111111110101111011111111011110111110001111001101110101101111011001101110111000010101111110111111111111
2112222210212001001222111111111111111101101000110101000111101110111001111111011111110101001110011111111111101111111011101101011111110111111101101110110111110101
0100101100021020222111001111110111111111111111111110110111111101011011011011111101110111010111111111111111100011010011111110110101011111001111100101110111111111
2110112022201122020121101101111110111111111011110011111111011101111111011111111111101111111111111111101111110011101110111101100111111101011111010111001011111111
1212121001111211210112211111011111111110101011111111111111101111110111011011110111111101110101011111111101111011101111111111111111111101110011111110111101100001
2211221111201001202120211011111111011110111111111110101111011111101111111111111111110111110111111011111111110111110111111111111111111110101011111111011111011111
1110212121101222101111211011111111110001110011110111111111111111011110110101111011100111101111111111011111111101011011101111101001110111101100110111111110111110
1112222212121122220121211111011111111111111011011111111111101111001001111111101111111100111101111110111101011111111010110100111111111111101111011011111111011111
1122202221211222112222111111111111111111111110111110010111111111110011111111111110110001111111111111111100110011110101111111111111011011000111010111111011011111
1210221111022212111011211111101111111110111101111111000111101111011110000101111111111101111010101101110111111011111011010111111101110111110111111101011111111110
1212022200222111222212111101111111111101111110001111111101111111110111101111111110111111101000111111111001111111011011101101111111111111111110110111101111111101
1021011122111002022221101111111111111011111111011101101011111100111111110111111011111111101011011010111010000111101101111111111111110111111011011011111110111011
2220112011022121111222211111111111111011011111110101011111110101010111011111101111111001011101111101001110111111111110110111011011101011111011111111111111011110
2121220112122120202222101111111111001111111111011111110101111111111111111101101011111001111101111111111111101111110011110101011110110101111111111111111101111111
2211122121120211101221211110111111001111110011011111111110111111111110111111111111001111111101101100111111110111111111111111111010111101101111110100111111011011
0121211121122221212222111110111110111110111111100111111111101110111111111110111111111111111101010111111110011110011011101111011111111111110000011111101101011110
2120102222111112021110110111111111011111010111111010011101111111111111101100111110010111100111110111111100111011101101110111101111111101011111111011101011111100
2110212201221202001011110101011001111111111011110011101101011111011011011111101111010010111111111111101111101111101111111111111111111110111111111101101011111111
1111021210222012121120100111111100011110111111111101111100111111111111111101011111111111011100111111111011111111111101100001011111111111111111111111111111111111
0120221120220202202112111110111011111111111101111001111111010111110111101010111111111111100011111101111111111101111111111011111111111111111111111101011110111111
1201001002211011111122201101001111111111111111101111111101010011101101101000101111111111111111111111111011111111111110011011011111111111111101101111111110111010
1221112201120021222222111110110101100111111111101111101111110011111101110110110110111011110111111101111111101101111111111011011111111111011111111111111011111110
2212110122011122022111211111111111111111011111011110011110101100010111111111111111111101010111101111101011100110011110111100101110011111011001101111110101111011
0211211112201012112001111101011222212211221012221122111001121111111110100111111111111110110111011111111111111100010101111011111111111101111111111011101010001111
1111122022011220211210011111111210211112202210201102200200221111110111001111111110101110110011011111100111011011111110111111111010111011101011101111001111011111
1120101122111110211120211111110110122210212102222121212012020011101101111111110011101011100001111100011011111111111111001111111110111111001111001111111111101101
1111211002211222022112001110111012020002021221211102121101111101011111111001101111011111111111011111011111111101101101111111111111111110101111111111111111010101
1212122222211210111111111111111020211011120222001220122121022011010110111111001111110111111110111111101101001111011011111111111111111111101111111011101111111111
1222002212121001101211201111111121222110022102210111022100202111110011011101101111111110110111100100100111111111110111011001111111101111111011111011110111111111
1110111010111111111111111111112220020210210111112212211001121101011011101111111111011110111111111111111111111011111111111111111010111010111111111011110111011101
1101111111111101011001100010011210001221022212110102221122221111110011011111111101111100110101111111111011111001101011110100101111011110011111001111110111111111
1111111010111011111111111101112011212011211022020111011111110011111111110110000110011111111111111101111110111111101111111101011111111111111111111101111011000110
0110111111110111001011101111100101111111121121020102010202222101121120010020220121011111111011111111001111111011110101110101111111111101110100110111110111111011
1111111110101011111010110111112102120100022122111120202012122220201212112020221220111010010111111111111111111011011101101001100111111101110101001111000111101111
0111011011111011101110111111000211211110210102121201222121220012110201221212221111000111111111111011010111111111111111011110111001111111110111111111110111011100
0110011111111010111011111111101211221112102121111012212022021101200220212220012021111110011101111111111011111111111111111111111111011111111111101111111011111111
1111111011110101101011111110111211110111020101212002220222201222211210000112201101011111110011111101111111101111111111111110100111111111110101011010111101111011
1111110011001111111001011110111021100212122202201122202122012002221111201121012220101011111111111100111111110001100011011110010110111111111111110111111110111111
1011111101111111111111111001112122021020202222122222110121221202122221121022112211111011010101111101100110111111111101111111111011001110111111101110111111111110
1111110100111111111011111101110022111011011122112222112222222021212112001012122221111110110011111111111111111101100111111111111011111111010110111111111111011101
1001111100111110111111111111112202210010210011122222122000210220222002212212221111111110101110011011110111101110110111111111111010110111111011111111100101111111
1111111111111111111111110111110110122110010000110121022111222010212220022111222220111101000111100011111110101111111110111101111111001010111111111011110101111111
1110110111111111111011001101111121210120222111122122222021021222221210110112221011111111011001111111101111111111011111001111110111121111211112122212021222112201
1001111101110010110111111111110011121121020221111100211121220111212022210222011000111111100111111111110111111110111110111111110122010112122212201120112222111021
0000110011111111101111110111112212100010122211100221211212022211112120011002102011111111001111111111111110111111111011111101100120222121202122020111112122212021
1011111111101111101011101110112202102201210222222022220112022212202102121111001211101011011110001111101111111101111111101111111111022202010122021212120221201121
0101111010111101011111110110110111101211121111212222222222220120011002110211102121111111111111111111010111111111111101110101111122022221122212221022110110102211
0111111111111111101001101111110020002222221221212020210101022212102121220221211100101111101111111111000110111111111111010001111102210202212022221022222201210021
1110111111110011111111001111111200120112202221222202100022202221221020221110121110111010110111111111011110111011111100111101111012111211222122101112112022212201
1111111111011111110111011111110201222220202220222102202222020211102022122221112001011101111110101001111111110010110111111110011121221122110110210111022210122101
1111111111111011111111101011102122022102221222222222002022220222220121011121121001111111111011011111111111001111111110001111111121122120011112111112022021201101
1111111000111101111111110100110121202221112211202102222122220211211101222212211120111111111110111011011001111111111101010111001110111102111112210102122221011021
1111100110110111011100001011011220122001221202220222022222022112021222101221220011001110110111111111011011111011111111111111110121112120221222111022122101212220
1111110111101010111011101011112202102020201221111212222220201222111201021221112221111101011111111010111111111001111111011110011020100122101102211212121122111221
1111111110110101010110111110101010121110021112122011210221222202121210220210210221101110101101111111111111111111101111101110101012220211121022120012211222111021
0111111111111111110100111111111111121100221022002202220222120122101122120122021001010011111100010111101000110011110101110111000101020222210212102111022221222121
1111111101111111100101111111101101102221121101111022220111222221222220202102221220111011111111111101101101111111011111101001111112202121112022111210012011022221
1100011111110110111101010111111101111012022222022202222120222122220100001100210121101101012211100022121221222112021111011111111121102201022020111221202111112201
1101011111110101010011011111111110011221102220220220222202212210022201212110202111112222220121212022201001211110021001110111111000111122212001212011020102111020
1011001100011111101111111110011111102120101112200221121012001122221010212110111211011201221111022211222122220122211111001111011110011121211101122112122122101021
1111111011101111010011101100011010121101121002112112102200220120021212102101121011011121220201020212012122012102010111111111111022221010110020202221111222111210
0111111011111111110011111111111111111110222220200022120002012112200001012120100101102112211012211210211011211011021111110111111112000212212221221121101121101221
1101111011001111111111000001011101102022121210112111121122122211002111110221222111121021002110211211212101102211221111001110111121020210211212221201121201022121
1001111010011110101101111101111111121001121212202220222121101122221011011111111110102212220111222221111222211102121101111111111110001102122200212100110222111221
1101110111111111111101110111110110121101112212222122222202022022210201112210111010112221122000021211102202122120121110111111111102110202210202121121122011222111
1111111111111100110101111101101110110201122222212121222022120122121101212211011101022212121021000010212102112222020111011011111011212122100121221201022121021111
1001111111011212022111211022221202201211221220222022222222201202210102012201111110101221021121202212012110222220101101111011110121122111212120120122220122101011
1011111111111122011222101122112212011200122222222221222211222100222212222111101111102111122121121111211222010112121010111111100121100102002210212202022021121221
1011110101110222012110212112102221012012221222022110222212222220202121110210101111102120102201102211211120110011220011111111101102100200221101022121100111201121
0111111110011222211111212110122111122022222002221222122202212021212011110201111111120011120221212112102210220212010101101111111120112221101122111101221221212201
1111011111111201222212211201111200222212022022222212210010222222222121021211111100111122022112112121212211102111110111111111111001121112211020202021110020122210
1111010111110020201001121210221212220012221022121222220220202222222111111021111111020220021022122020212221120121121111111111010012110100102122220111101210221211
1111111111101022220101001112220101122102222012201202212012202200201121111101111100112000121212222000102020001111021111111011111020011211022222102120122222201220
1111111111111002011201211021210210110222222220122222220200122222000102112211111101121211012222012111121121022112210010110110111111101111111111101111011010111111
1010110111010021211121000122020220001212122012212200221220212122222212122121111001120110101220120102111221211111200011011011111111001111111111111111011010011111
1101111111111220011210221201222022122122002002221222120212122202221221200200101111102020121012212222110012122101111101001111111111100111111011101111001111010111
1101111011011122110120120121121212122222022012200212212202220222220112222111111010001211122112122211211112111112201110111110011101111101110111111111101110011011
1111111111111212102221222000122202222222222021010112222222000022221212212201111111100222212211111212112122111111121111111011111111111110110111110111111111011010
1001011111111021012112211012222221211102112212111212122022222222100211201111101110102211010222021102102122112201121011111111111111100110101111101101111111011111
1101111011011122001122221002122221220011222210122012110222111211011202101200111011011101010221022111221221112210211111111111111110101111100101111111101101111110
1111111111111100201020102212112012112102120122222221101211120122022122001021111111121122121201120222011121220222221110111011110111111111110111111101011111011110
1101101010100111101110201111022221211221102122122002221001211212201112011221110011121200211202222111112010102211111111110111011111110100001100111111111000011111
1111100110101100012121022111021222122201111211020111111110211202022121222211011111121111122212222021121001212010220010111110111011111101111111111101011101111111
1111110111110212221121222022112100220102222012122222012202101120212220000120101111110101112021211222212020100201011101011111011111101110101110110011111111100111
1111011101111012011212022112022202101221002221100212210021211200202111011211111110011121122212010012102211202220211111100101111111111111011101100111110111111110
0111111111010012200112210020001122011020011022120121012202201001121101122011011111101001201002201211212022102012120001111111111101111111101011101111001111111011
1111100011101112212211121212112012221211011201000200121221212102211121111221111011021102001111212121201112022022011101111101110110100111111111111111111011010111
1111111111111222211120212112122210022012022202201211011011022200122012220211101110112100212112111220122212111221001110111111111111111011111111111101011111111001
0111100100001112011212222112211112121121211022122221122111002110121211022111110110011011111111111111111011100101100111011111111011111110100011110110011101111111
1111110110101012212202211211112110100122122212011121100222200222221021222201111111111011011111011110101111011111111111011111111111111101010111101111111011111011
1111111111111211012102122210002022121222120111211221111011121010101110212121001111001111111111111101111101001111111111111101111111110101111100111101111101111111
1111110101111120211121220211211202211200112201211001101212111212221101022111111101111111110101110111110011111111111011111101111111101011111101011101111111111111
1111101011111020122221222011222002211111112221222002202121022101210202020220111110111111111111110011111011111101101000110111101111001111000110011111111001110111
1101011111111002121211122112110011200222002211222212010011012212122212120220111111111011010111101111101101111011001111110011111110111010101111011111101111111111
1111101110011220002120221200212112012121102022101212101201022222200100110111111011110111010110101111011011011111111111111111101111011101111011101111111111101011
