110 8
10 146
49 33
57 69
91 4
40 76
51 3
87 70
63 78
47 79
11111111011111101011011011111111010a11101101111011011110010a011111111010101a0101101100011011111111111100110110100111111100111101111111011110110010111011111a1111
00011010011111111111111111111110111a10001111100111111011111a110110111110110a1101111111101111011001111111100111011111011111011111111011011001111101111111101a1111
00111111111101111101111101001111111a11111111111111011111110a011111100111101a1110111111110001111110011111111111011111111100111100110111101111111111111111111a1111
11100011001111011001110101101011110a11111101001100110111111a111011111010110a1011110100111101101111101111111011011111111111011111111111111111111110111110111a1011
11111111101011010011011010111111111a01011110011011010111110a111111111010110a0101111111110111111111111111111111111111111101110111111011110111011011111110100a0011
01111111110111111101111011010000011a11111101111111111101111a111111110001011a1111111011111011111111111011010111110011111101011111110111111101111010001100111a1111
01101111011111100011111101111111011a11101111110111001111111a101001100111101a1001111111011111111010111100101101111011111111110101100111111101111110111011101a1111
01011111111111011111111111100101110a11111110101111011111111a111110010110111a1111101111111111111111111111101111111111101110111001011111011101011111001110111a1111
11111110101111111110110111111111011a11101110011111111111111a001110101111111a1100111101111111110111000101101110111111111111101111111111011111111001110011111a1111
11110111011101111101111111111111101a11111111011110111111011a111011111111101a1111111111010111001110111111011111111111111101111111111010101111111011111010111a1011
11101111110110111011111111001111101a11011011110111100111101a111011011111101a1100110111011101111011011111010011111110111111011011111110011101111101111011101a1111
11101101110101111111001111101100111a11110111111111101011111a110011101111000a1111101111011111111110110111100000111110011101111110011111011111111011111011110a1110
11111111010010111111111101111001111a11111101111111111111101a101110111111100a1101011110111111101111011111011111110110111111111011111111110111111111111101011a1100
10001111011011101111011101111111111a11111111101111111011111a111111111001011a1011101001011111111011101110111111111110111011111101010111111111111111101111011a1101
11110101011111111111111011110111011a11111111101110111010111a101111011100101a1110110111011101111111011111100110110111111111111111101111011111111111111111000a1011
11110111111110111111011110111110110a11111011111101111110011a111111110011101a0111010111111111111001111110111111110101110110111011101100110011111111011101101a1010
11111111111111111111111111111101011a11110110110110101101111a111101111111111a1011111111111111111111101111111110111101101011101101101111111101110000101111010a1101
10101101111100101101011101101111001a01111101011101101011011a111101110110111a1101100100111111111111011111111110111011111111111101101111111110111110100011111a0110
00111111101110111110111111111110111a10110110110111111111100a111111111111110a1111111111111111111111111111010110111111110111111101111111111111111011010101111a1111
11101110010110110101101111111111111aaaaaaaaaaaaaaaaaaaaa111a110111111111110a0111100111111111111010010101110111101111111011110111111101011111111101111111011a1111
1110101010011111111110101011011100111111111101111111111a111a001101111100111a1000111011100111101111111111111101110111110011010101111111010011111111111111111a0111
1111011011110110111100111011111011010111111111111110111a111a111011110111111a1000111111011110101001111111101101111111111110101001111101111111011111011111010a1110
1111101011111111001101111111111001111001110011011101010a011a111101111010111a1111111111111011110111110101111010111100001101111111111110100011011111011111111a1111
1011101111111111111111111111101011110111111111111011111a111a111111110111110a1110000111100101110111010111111100111111011111110111111111110111110111111110111a0011
1010111111101111111101111111111110100111111011111111001a111a111111011111011a0110011100110101111111110110111011111111111011011011111111011111111010111110101a1111
1111111011110111100010111010101111111111111111111111010a110a002212022201111a2021200121101212111011111101111101111101111111101111011111101111011111111111110a0101
0101110111101001110111111111100101111111111111111111111a101a111200122111002b2012122010202112111110111111011111111110111111110111110111110111110010111011001a1111
1011111111111011011100110011111111011111111111110011111a111a122222022212210a1021210022122201110010110111100111001111111100111011111111101111111111111001011a1111
1101110111101101111101011011101101110100011011110011111a111a110210211020010b1212021022210111111101111111111111101100111111110111111101110111000011111111111a0111
1110111101110110011111111111101111101100111010111111111a110a121201201112001b1001012101021022111111111111111111110111110110111011110111110111111011111111101a1101
1111011110111111100101011111001111111101111111111111111a011a121021211222200a2202021010012210111011111011110110010111011111111111111101011110101010011101111a0111
1110110101101100100110011001111111111111001111111010011a111a012222012120010a2001121210201112111110101110101111111010011011100111101010010011110111111111100a1111
1111110111011111111100101011111111111111111110011111110a111a122122000221112b2220222121222020222111111101111111101101111111111110101111011111110111111111111a1011
1110100111111110111101111111111111101110111001111110011a111a120022221110222b0212212002212110111110100001110011111101001010111111110101100111011101011110110a1110
1111111110111111110201212102222112212111111121211111111a101a011220221012020b1201120022220201222101111101101011111111010111111111101111101011010111011001101a1111
1101110111111111012121111122110111210120202201002111011a111a122122212222222b2020020120222210201111110101110111111000111101111011111011101111111100011111111a1100
0112222112220122222102222212211121222000012121111000111a110a121002212122012a1021221221221010210111111111111111111100111111111001111111101101111111111110111a1111
1212202222102121012121201022001200000112202021111111101a101a122100210212211b0011020211021221000111111111111111111111111111111111101011001111010011000101111a1111
2222112221212002202120012220212012210121021111121011101a111a121020101221211b2022202211222020010110101111101111111111111110011111110111100101111111011111111a1011
aabaaabaaaaabaabbbbabbabaababbbabababbbaabbbbabbaaaaaaaa011a120102220222122b2201221220022202110111111111111111111111111001111101111100111111001111011111111a1111
21220011201220112122102110102120102212101110212111111111110a121210120212222b2121111222021200012101111111111111011111111111011011110111011100011101111100011a1111
21221110121102120121101102222212011100221102101011110111100a111222022212222b2221222212022202121111101111101111111111111010111011101110111110111011111110111a1111
12121210210222020202211011121122220222121221221121111011220b022002200202222b1222011110210120212111111001110111111011111111110111110111101011111000110111111a1111
12202000122221222221021102200112012102222122201011111101121a001100222222222b2122222222220100111111111100111111111110110111111111001111111110011110111110111a1111
abbbbabbaaaaaabbbbbaaabaabbbabaababaaabaaaabaababaaaaaababab222122022222022b2112022022122212122110111111110111101111111110111111110011111111101111110111111a1110
122212121211111001202222212100121111102120101122211111110110222222222222221b0202201221002201100111001111011111101111011111101101101111110111111011110011101a1100
100101021120210012211211021220221210201102101112211111212220200022212222212a2222021212200212200011010111111111011001110111101111111001111101111111011101110a1111
100222212012212122022122021222002010002220102111110111221112122120022222200b2222022222222012222101101011101111110111111101011111111110110111111110101111111a1111
120100221200211001011021100111220212122210120022111111102000002222202220220b2122222221020120122111111111101110111100110110011111111111111010110111111111011a0111
201112111222222020202221010122120211220111111102211111110022112222222222222b2222222222222222022011010101011011111101110110110110101111101111100011110011011a1111
111021202200111112202122202010012021111012202111211011022221122222022222220b2222222222222222222111111111110111110101111011011110100111111111111011011111111a1101
210102000122010112012001202020221211211111100122110110002022222200022222222a1220222200022220022110101011011111110110011111111111001111110110111111011001111a1011
201211202111221021111112001202121111021022020222201111110221021222222222220b1212222201122020200111101111101111111011010110100111111101011111111111111111111a1011
111212101212221112022122022022111011010112212220111000012111222222022202222b0220222222222211211011100101111111111111011111001111100011011100101110110110111a1101
102200211101110201210101121221121120111112020120210100220021012222220222220b2202222222222120220101111111101110111111111111001111110111111111110110111101111a0111
210211111011212121001212212021022211112121012012111101112012221022222222222b2222100102222220020110101111111011111111110110010110011111000110010111101111110a0111
100122200120111110001212211222112011200100220022211101221222122200100210221b2222220211002110122111101101111101111110011001101111111111111111111110110001110a1111
110110102012102111210112211201021121120010222122201111222021211122222202202b2022222220121220212110111111111111101111001111101111101111111101111111100111111a0111
011221012211200111112202121210121122211221220122101110121221120210002022102b2022220001222220221111111100111110110111110111111101111111111111111111110111111a1111
020100221222212111110210011122121212012222201111210110011211121012221122222b210220210220220212011111110111101111111aaaaaaaaaaaaaaaaaaaaaaaaaaaaaaaaaaaaaaaaa1111
222222000001110022021112222012122100122002222022111111221220121202120221202b220022222022201202111111111011111111111a01111111111110011111111111111110101111101111
212011110121122201221021111021122220100121022021011101121012110212220222222b212222202212220102111111111111100111110a11101111111111101011111101111110110010111111
211021212210002220221212021010122122002121112111111111012210022212010022222b222210222120021002211111111111111011011a01111011110011111011111001111111111111101101
011121221210121022021112202221220021111212112112111011020221112222020022212b122222202201201210111110111010111111110a11010110111111111111111011011110110110111111
122102120111122211210222102121102120211220212221210101110122220210220222212b220211222002121211111110011110111100000a10101111111111101111101111111111101011111111
101211111020212002111111011111011111110111101110100101201211111020221201222b120221012212211011111011101111111010111a01111010111110111111111001111110110111001101
101222122121212100211111111110101111111011101011111110221101011012222000002b022111021211010022111011011111111111111a10011101111111101111010110110111101111011110
111111010110111011111111110111111111001011111111110101111122211222022220222b222220211111211101011111111011111111010a10111111111101011111111111110111001100011111
111111111111111111110110111110101111101111111111101101101200111221022211120b202212122011202102111011110011110011010a10111111000001011101110101111101110100011100
111101111001101101110111111111111101101011111111110101201221022012100022122a212022222120202122100101110110010101111a11011001001111101111011001111011111100111111
111111011111110111110110110011001111111111111100001110210120102202222221222b210212012122122120110100111010111001111a10101111110111111001111011111111110001110111
111111010110111101111111111011110111011011111110111111202211111220220221222b222222222120021021011010110111011001111a11101101011111011111111011111111111011011010
011011110100010111011111101101011110110111110011111011112012120022212222220a202212120111012110111101111111111111010a11111011111111111111011011101001011011111101
100111111111011100001111101101101111111100110101111001102112200222222121222a122022210202102211111111111111110111111a00101111111111011111010111111111111100111011
111101111101101110110110111111111110100011111111111111110110001220021221122b212221221012121201111111111111111111111a10111111001111111100111100111111101110011101
111101111111001100111101111110101110111001111111110011112102201101222122201b222221212201020221111110111111111110101a10111100110110111111101111001111100111011101
200001121211211121201011110110100111100111111101111110022210112010220210222b220212000102122122111101110010011111111a11111111011001111100101110111111010010111111
120021222200011211111111111111111111011111010111110001122122211102112210022a222122021212221222011110111111110110111a11101111011111101111010100001100110100100111
220022221111220211221101011111111111110111010111001111020121111002221122222b221122110202221201110100111011111111101a11111101111111111111101101011111111111111111
202022120202102110121110111000011100001011111111011011122120122111120202002a010112211211101011111111100111110101011a11011101110111101101101110011111111111111111
121211110222210110201111111010010010011111111111101110122122210120121121111b121222022211010001111011101010100101111a11110111111111101111111111100111011111110001
222120112112111111111101110010110011111111110011100001012100012221020002222b210000001111111111111110111111101101110a11111101110111111111110111111110111100111101
110121112222210010221110111101010111101011111101110111101221111020211111221a210202211011111101111111110111111111101a10011110111111011011111011111111000111110100
210110012120121121121110111110101101111111111111111111121112200201121102022a110222011211101111111110111110111111111a10111111110111111110010110110111111111111011
020011202111121221220100111101101110111010111101101011122112222121220011222a120110211101011000111111110111000111101a11011111111111001111110111110101111010111111
122121101100022211111111110011110111011011010111111010111220012112122021210b202102012111111011111111101011111111110a01011111111110001011111101011001101111111111
120222112222102201121111110011111111110111111101101011002001220111022022201a102202202211011011111011111111110101110a11110101011101011111011111100111010111110111
222120122001111221221110111011111111110111011110110110020122020011212220210b111120122211110111101011001111110001011a11111111101111111110111111110011110111101111
111202000121201110011110111111101111110101011011110111011101101212111111220b201101202111111111011111111111111111111a01101111111111011111111101011110111110111011
011102201022111121211111011111011111100111111011011111112111221110221211121b021122011211111111111101110111111101011a11111001111111000111111101101111111111111101
220012112211222120221111111110100011001110110111111111022102002122122101111b212022212111111111111011111110111111101a11111111111101111101110111101111111101111111
220101221200201220211110011101111100011111111010011000020110221121112222112b102012101211111011111111110101111111111a11111001011001111011111101111111110101110111
120010220212112221101110110001111111011110111111110111112122110021021221201b102222221210011111111111110101100111111a11011110101111111101011111111101111101011111
112110022210211200221111111111111110101101101101011111101100000020221211220b201221201110111010101110111101111111111a10111111111111111111111111111101110110111101
201022110110202110221100111010111111011111110111011011111111120200012011122b221111220110111110001011111111111110111a01101111111110111010110111110011101101011111
112222122221200121111110111111110011101111111001001011121201222021121120212a221210001111110101110111111011111101111a01101111101011110011111111100111111111111011
002111220020222122221110000001101100111011111111111111102121100001222002011a021221022011110110111111110010110111101a00111111110111111101100111101001101111101111
010111112112211121121111011111111111111110110111101111010211212021122012122b021211202111111011111111111110111101100a11111111110111011011111110011011111111110011
000102212022012212100100100010111010011001111111111101121221121101122211110a022200102011111110111111111101111111111a11101111111111111110101111111110111111111010
121221200210110001010110101111111111011110111010111111112122121210211221211b220122201111111111111010111111111110101a101111111111110011111111101111011101101aaaaa
121022222012112121211111101101111110111111111101011011122200012020221210210b111211200111111011111110111110111010111a111110001111111111111101111110011111101a1111
211102222110220221011001010111010011110010111101101101120221222100111112010b212221112100101111111101111111110000111a100111111111111100111111111111111101111a1111
211202012221100011101011111111010001110111111101111111111010210022122201102b201102101211011011001011100111111111111a011010101011111011110111111011111111111a0001
022210022002021122101011100111011011110111101111110011111111110111100010110a110000111101111111111101111111111111011a110111101110111011101100111110011111001a1101
011222121221122221201111010111111111110101111110111001111101010101111111110a111010011111111011111111111111010010111a111111111101001111111111011101111111110a1101
211021111021121201101101111111111110111110011111011111111111110101111011111a011110011001111111010111100101111100111a111011111111111111111111111111101011111a1111
022111101010020122221110111001111111011110011011111101111011111111111111110a011011101111111111110110111111111101110a011111101110111111111111111111011111110a1011
111110011110111111011010111011110100101101100101001011111111110111111011111a101111111010100110111111110111111111111a111101111111111101111111011111111011111a1111
111111111011111110011101011111101110111111111011111111111111110101111101111a111101110110111111111110011111001111111a100111100111101111111111111101111111101a0110
111111111011111111110001010110110011111110101011111011111001111111111111111a111111111101111111001111100111111111101a111111111011111110100011111111111111010a1101
101111101111111111001110011110111111011101011111110101011111111111101111111a111111111110111110011111111101111111110a111110111111111111111111011111111111111a1011
111111101011101101101111111011110110101011011111111011111110111001011111101a110011111011110110111101111111111101111a011001001111011111111111111011011111011a1111
101110111010111101011111110111111111111011011011111111011110111111111011111a111011011101111111110011101111111101011a111111101111110110111101101111111111011a0111
100001111111110010100110111101001101111101110111010011101110111111111110111a110110101101111101111111100111011111111a101111011110110111111111111011111010011a1110
101111101111001101010000111011001110111111011111111111110110111111111111110a111101111011111100010111111111100101111a111101010111111110111101001101101111111a1111
111011110101010110110101011111111100101111101110111111110111110111111101111a111111111111011010111101100111111111111a011110101111001101111110111101111110110a1101
100111111111111111101011100111110110111010111011101001111110101111111111110a001101111111001110111111110101110111011a100101111001100111001111011101111000110a0011
001011101101111001010111111011101101111111111111111111101110101010111110111a111000111111111111111111110001111111101a111101111111110011111111111111111011110a1011
111111011111101111111101111111101110110011111111111111010101111111011110101a111011011111111111111110111010110111111a001100011111111100110111111111101111111a1111
111111111011111011111010111101111101111111111011111111111110010001111101110a111111100010011111111111111101101011111aaaaaaaaaaaaaaaaaaaaaaaaaaaaaaaaaaaaaaaaa1110
