105 156
0 143
96 25
111 147
14 103
15 14
2 151
49 52
75 23
41 93
121222222220222022211112021121110101111a1001111111111011110111101110110011101000011111111121202210011112122110211201122111111111100011010120112201011121021a2211
101011221111012120111121011212111110111a1101101111111111111111111111111100111011111001111010111212101200121121002022222111111111110110110222202001012122102b2112
200112212202110110120111011222111011110a0111000111111011111111110111111110111110111111111102210100112122112211212020202111011011111111112120201222120122011a1121
202001120202221121022021111011011111111a1101111111101111111111001111111011101011110001112211221110100111110021221101101111111110101111112212012212202111101a1100
211000212202120012022211210221100011111a1101111111110111011110011110111001111111111111112001021120110102202122102211222111000111101101111112101202122120121b2122
211212202100022112122222212101101100101a1110110011111111111111111110110110101110111111012122012111111222011201101110111010010011111100111110110111201111021b0122
120210202121121121012111122122101111111a1111101010111111110111101111111100111111111111111010221120101011121222101221110111111101110001010221122012012011001a2012
112211121122021211220012101121101111101a1111101100100111111011010111111001111100010110112010222222022122022201112112122111100011011111101212101111011102222b2201
112211210001002101111100111122111111011a1111101011111100101000111110111111111101111111111211200211221210120112100111222011101011011011110122102112212102220a2220
111012000101112121201201222201110111111a1101111010111111111111111111111010111111111001110002200200211012211102012120221111111111111101102200101112110102121a0201
111022211111202112121102211210111110100a1111111111110101111101111111100111010111011011001010100110211201221212021011121011111111111110110012011211011112102a0101
122201112011210002102200221222111111111a1111110000111110111011111111111111101111111010110112210201000220221212211201120111100111111111102211122101020221121a1112
122112210120220100122222112212111111110a1011110011111111001011111111110110111111101111112220111002122211012022001021111111111111111100101221120212020002221a2111
222222022201000112210012212021111110101a1111111010111101001111110111011111111010111111112212102011112222110212112220000111001111111110111222200121101211210a1212
212222211111102110202212101212111111111a1011010111111111011011001111101111010111111111111201222211222120111012122220112011111111100010012111211222011222020b1210
201220122011212002220211112111111111001a1111011011011111111111111111111011011111011111102010122211110101100121002201220111111101001100111221012122021001202b1011
222212121212222112012221122022101111111a1100110101111111111111111111111111111011111111111111111211110222222112201122011111111111111111102110122011112222001b1111
121112222112110221012221110212111101110a1111111101001001111101100111011111001111011111112222012101111212221122102120222011110111111110112221102211211101101a2111
201102220202110022201210020222110100111a1111111111111111111011101101100110101101110110101111211121221020222120020121202111110111110101111111110110011111111a1111
121200221122221220121220222122110011111aaaaaaaaaaaaaaaaaaaaaaaaaaaaaaaaaaaaaaaaa111111101221221210021012111112101112112111110011111111110111011111111100111a1111
2021022112212221002102220121220010111111100111111111010111111101111111011111111a111111112211102121222021222221212122220111111100111010101111011011111110001a1111
0112112021222101212222101210210101111010101101111111111111111111111011111111111a110101002022211112010122101111012211221111111110101111011111110111111111111a0111
1201011210221222021102111221221101111111111001011001011111011111110111110110110a010110011102101101102122122120111121012111011010100001111100011111111110111a1100
1211001212012212221211212200020111111101110111101111111111111010110101111110101a111111111012211010120021102202212112102010101111111111111011111010110111110a1111
2121111221222121111112102221201010011111110111111111101011110111111111111110010a111011102210112010011211222122111220111111011111001111011001110110000111111a0111
1212212021121112121221211210010011110111111101111101111111011111111111111111111a111110112002211022022211210111212211222110101111101111011110001111011100011a1111
1222212110111010010212020120111111101111110011111011011101111111110001111111112b221221012221202201122012221102100010201111111111111111111110111111111001101a0110
1111122211100222122211002110021111111111101111111000001110010111111001011111112a212221022112202210002200222000121121000101110011111111111101011111011111100a1111
2212011120211112222210211122211101101011010011111111100110111111011110011011112b211021022122221022222100220221122110111111101110111111111111111111111111110a1111
0111111121012000021222222210101011111011111010110110111011100111111101111111112a120212112212222110221222222221210221010111011110111101011111101111111111101a1101
1212112111200111121220021021211011111111110110111111111111110011111111111111010b111121000212021211012012220111111111111111111111101111100011011010111111110a1011
0011101110100111101111111111110011011111111100110111011111110111101110110111101a010221022101220022101122221021111100111011111101010111010110101011111011101a1111
1111111110001011111110101110110010111111111011100111011111100110111111011110112a011000201111222101112111101201111111111011111001111111111110111111010111111a1111
0101111110111011111101111111111011011011111011101111011110110111110110110111110b211111121221221012202001112221111001111100111111110011101101111111111001110a1110
1010111111101111110101111111111111111010110102202221011001010011012110110011102a221101201200120111111122202201111111011110111011111111110111111101110111101a0011
1111011110111101011101111011101110011201112211201211122000122122122211110111111b011100202200100111022222122211110111111110111111110101111101111111100010111a0111
1111101011111111111111111111111111111101110112112001011202221210112200111111102a112011121211011011222121211111011111110111110111111011100101111111111111111a1101
0111110000111011111010000110011111111122121101200201200111200222212111111110110a100001002221001210002002101221111001111111110101111111111111110010011111111a1110
1110111110111101100110111111111111111121112110211212110221021102021211111110112a212121122111022021220200212110101111111010111101111011111101010111111001000a0111
aaaaaaaaaaaaaaaaaaaaaaaaaaaaaaaaaaaaaaaabaaaaaaabbabababbbbaaababaabaaaaaaaaaaab111222211121202200222122110220111111011101111111101110111001101111011011111a1101
111100111111111011110111111111101111011220202110212100120021022111121111111aaababbbbbbaabbabaabbaaabaabbababbaaaaaaaaaaaaaaaaaaaaaaaaaaaaaaaaaaaaaaaaaaaaaaa1111
111111101111111111111101101111101111022121112011111200122101211122121101111a111022121121222212211021011222122111111111101110001111110011011111111001011110111111
111111101010010111101101110011111110100111212201221201111111102010211011111a112212100220010021121202012021222101111101001011111011110111111110001111111110011110
111111111101111111011111111110111111112110202211101022122010002201210101111a110111121101102220110110200211111101111111101010011001111111011111110111110111001110
011111101111111111011111111111110111120110001122011122222101111222101111101a112220022102112210200211211022021111011111110101111110100101111101011111011111110011
011011111111111111101111111111100111112111120022022112112221221121121111111a112101200120221221222101111212101111111111111110111011111111111101111111111111111111
111111111111111111111111111111110111112222202011122120221212212201221110111a111122021221012211221212211212022111010000101111011000011101111011111111111111001110
110111101011111111011110101101111111112201221200110202021012102020021110111a010120222221021102222221122211012111110110101101111111111001111101111111101111111111
111000111011111111111011111111111111012212021221220012120112111020201111111a112100120022012221011121212222122110101111001101101110111111111111111111010111111110
101010101111110111111110111111111100112121012010211202211002120122210111110a112002001211122112011122122112120110110010010111011101110111011111111111100110101110
111111111111110111111111011111111111110121201222121202111222210212200111111a110012220202202222211000100220222010111111111101111101011111011111111111011111110111
111010111111101001100100011010111011110001002222021222220022220212201101010a110121222212111121022122212210212111010111101001101111111111111101101111011011101111
111111111111111111111101111111101110111202221110220212000112220110221111111a111210212112110101212020211021202111111011010100111111111111111011111101101111111011
111111111011001111111111111110101010022002211120221112000001021212121111011a011020011212002021102211111121122011010010111111111101100011001110011101010111101110
111011111100011111111110001011111111111101011202222202211021210211011111111a111121202102001022021222011212111011011101011011110111111010100111111111111101101101
101111111111101110101111101111001110101210221111120220020122102110111110101a102020021010011020112021112111221111111111101111011111110111011111111111011101111110
110110111111011101111111111111111111102121221210212021012212201121201111111a111111102210121110202210202212122111001101111111111111111111101111110111110101111011
011111111111110111110111000111110111101212202011210002221102001021220111110a101111111101111111011110101100111111111011111111111111111111011001111111101111000111
111101111110011001110111111101111111010201212121212222222110210222120111111a010101111011111111111101111111111101111101110011111111111111111110101111111010010101
010011111111011111111111111111001111012001121201221212100202122121120101111a111100110111110011000010110111111111111111101001111111111100101111111111101101001111
010111111120122112011102121120111111212201020120112212210121221002011111101a110110011111111111111010010111011110111100101011111110111111111111101101111111010111
111011010012222021212210212212110212212111012211212201220201011221210101110a111111111111111110111010110001100101111111110011001110111111111111011101011101110111
111110111212222212022102022121111111212102122212202011110002100222221111101a011111111110110111001111111111101011011111111111111111011111110011001111111110111110
111111111020211022122112210101112111222112211222001022110120010210220111111a101110011111100111110110111101111110111111111010101101110111111110110101110111111111
110111002210111210211222111120210212000122111222222221112120210222121100111a111111111101110100011011100111111111111101111011111111010101110111110110101010010111
010001010120012222211020100022201221201111111110111111111111001110111101001a101110010101111111111111110111101111101111011011111101111111111111111011110001111001
100111010110112110122222221112222221121101100111111111111011111011110011111a111110100111101111011111011111110110111111110010111111001110110111011111111111101110
111111110122112101001111202202112022221111011011110111111111101111110111111a111111101111111111000111111011101011111101111111111101011110111101101100011111111011
111111111200200211121122111112212122201111101101111111111111101111111011111a101111001111111111101101011110110111111011111111010011111111110111111101001101100101
011111111220221001221111000021012220011001110011110110011111111110111111011a111111111101011110111111111011111111100111111110110101111101011110111111111111011110
111111101121022010012212112112011211112101111011111110110101111111111111111a101110011101111111000110111111111111011110111111011010110111111111111101111011011111
111111101222022022110220201002211222201111110000111111100001011111011111111a111111111110111001001111001111111011101100111110111111111011010111111111110111111111
111101011121211122201221011211220111120111101111111111111011111011110011111a100111110110101110011111111101110101101111110101110111111001011111111111100010111111
010101102102002222102202201112111010202100110111111010111111011111101111101a110111111111110111110111011111001111111110111111101011110111111111101111111100111111
100111101211010220211101222011121202011110110110111011001111111110010110111a111101101111011101011100110111110110111000101110111111100111101111111111111111011110
111111111220120121202221112111122112210111011001110111011011011110001110110a101110110111110110111111001111101110111101111111111011100101111011111101101111101111
001111012101112201002201022210221120112111110111110111001010101111110111111a011101110011111111110111011111111110101010111111011000111111111111110111011111011111
001100111122100012220212201200200022112111011111110111110110011111011101100a111111011110011001101111101110111011100110111011101110110111110001011011101111111111
111000010100102121222222221212221201012110111101111001100111111110110111011a011111111111101110111110110111111011111111110100111111111111111111110001011011111110
101110111120121222201220112212020211002100111111111111111111101110111101011a111011011110111101011111101111111111101110111000111111011011011111110110111100101111
111100aaabbabbbbaabbabaaaaabaabaaaaababaaaaaaaaaaaaaaaaaaaaaaaaaaaa11111100a10011011111011111111aaaaaaaaaaaaaaaaaaaaaaaaaaaaaaaaaaaaaaaaa11011110101101011100010
111111a11122201220120111222021200201211001111111011111101011111111a11111111a11011111101111100111a111111101011111111101011111111111101111a11100011001011110110111
100111a11102122022221222211222222022022210111011110100001101101111a11111111a01000111111101110011a111111101111111100101101010111011100010a01110111111101111000111
111111a12012222012122220222021222002022121111011011111111101010000a11111111a01111101001101010110a111111110011101110011111111111101111110a01110111101100101110101
011101a02022022222221202212202211121221221011111111110010111001111a11111111a11111011010000111111a111111111111101110100011101111110101111a01110111011110111111011
111101a02012122121221121202110220202222110110111111111011001011111a10110111a01101111110001110111a111101011110110011111111111111111111111a10111110011111111110111
111111a10120121022112122222022020112220210110110111011110111111111a01110111a10101110101011111011a011011101111111111011111111011010011111a10111111101111001011110
101110a12200202000122001221202020222222011010011110110110111111111a11011100a11111101101101111101a011111111111011111101111101111010111110a01111111111000111101010
111111a01212222021201220122222100022002021110111101111101011011011a11111111a11101110111111111010a111110111111101111111101101110001111111a01001111111110101111110
101111a12020221221222022222010222212221121111111111011100010011011a11111111a01011101101101011111a111111011101101001100111111011101111010a11111110111111111111111
100110a12200202220122112122022221222212121111111110110101111011010a10001111a11011111111100111111a111111111111111111111110111111011110100a01111111011111000111101
101111a11100221211102022112201122111220111011011110111011110111011a11111111a11101111111101111111a111111111101101101110101111101011111101a11011111011111111000011
101111a11120002222111112201222220222021101111111011110101111011110a11111110a11111011111111101101a011111110111111111111101111011111111111a11111011111111111101011
111111a01111011111100210022111022210121210101001110111111111111111a11010100a11111101111111111011a111111101100001111011110111110110110101a10101110111010111111011
010101a11022010221210012122221012012102101111111101001111110010111a11100111a11111101111111111101a011010110111100101111000111110111111011a11111011111111111111101
111110a11012101211122111000100111221111200111101111111111110110111a11101111a10111111101100011100a101011111111110101111101111111110111111a11110111101101110110111
111001a11121122111121122001222120020002111010101000001111101001111a10111111a11111011010101111011a001111011101101101110111011111111010211a10222221212220221222110
011111a01121102200112212122122011012211200011001110111101010011111a00111111a11111111111011101111a111111111111010101111011101010001111212b21111011021120210220111
110110a01121101101110221120122212221210211011010111111010111111101a11111111a00111111011110111111a001110110111111111011010110111011111021b12111101112222221101201
111110a11000212202102122202210202111212121011001001111101110101101a10011101a10111111011111111111a111111011111111111110111111101111102222a20101202220212221122201
111111a00121121121211120202112202102021221111110111101111111111110a11110111a11111100001001101111a101111110111100111111001110111111111120b12211121112022122200222
111111a11121012112201211111211121121101221110001011111011011001111a01111111a11111111001111001101a111111010110101111111111101101111112012a12012011111202220222222
111010a11122122011100221101112112200021221111111001011111100111011a11111010a11111111111101111111a011010111111111110110111110111011112101b11120120222110222002210
111011a11012211221202212201212200221101221011111111011100101001111a10111011a10111111111111111101a111111100110100101011101110010101110221a11101201221220112022112
110111a11122201201011220201212222121011221111111111111011111111001a11111111a00000111111111110111a111101101111101110110110101011011001212a00212011111211100012212
110110a10111112221000021201201112211112111111111110110111011111100a10111111a10111111111111011011a010011011111111101111011101110110011202b10112021000220211211111
110101a01120102210121000112111112111220211111111111111111111111011a10111111a11111010111110111111a110101111101111111001110111101111111012a12022112022122112202121
111101a11022212100221212221012020101120111001111111001111110101111a00011111a01111010011101111110a011101111111111111110011111011110100112b12221021222212001221221
111101a11022122210122121001212001220111111111111110111110110111111a11111111a01111110010110011111a111001111110101101100110111001100102112a12122001212210021212201
101110a11111212212022111010011110122100121111111111011101010100011a11111111a11011111000111101111a111101011001010101111111001111110102101b22211002121020222012120
111101a11122222111201111112202122120210021111111001001011011101111a11111111a10111111111110001111a111111101110111111011101101111110112211a22110112100121212121121
011101a11102022221110120211212102022101020101111101111111110110101a11101001a11001111011111111111a111100111111000111111011100011111112002b10112121211011220101011
110101a11111101011111111111110110111101111111101101111101111011001a01110111a11111111111111110111a111111111011111111111111111111011112220b21002021200202121122121
100101a11111000001011110110101111101011101011111101110011001101110a11111101a11010110101111111011a110011101111111111101111110110101111120b11210222222221111222102
111111a11110110111111110010101111110111011101111001011111110111111a11111011a01110111011110011111a111111111011110111010010110111111002212b21222121220221221010012
111010a11110111111011111111011111111111111101111001111111111110111a11011111a11011011111111101110a111011001010111101111001111111111111212a02002012102021010000121
110111a11111111011111110111111101110111101100111111111101011011111a01101010a10101110011111111111a111111011110111011111111111011111110111a11110111122121201211111
111010a11111111111110111111110111101111110111111011111101111111111a00101111a11111111110001101110a110111010011111111111111111111101111121a00211120222122120201202
111111a11011111111111111111101111111110111111111101110111111001111a10110111a11111111110111110111a111101111110001100111111011010111112121b02202012201220120111110
111111a10110110101001111110101111111100111101110011101101111110010a10111111a10100111101111110001a101111111011001011111011111011101100222b11012020120111102110221
