6 153
117 144
58 148
57 37
25 155
102 98
98 137
56 133
104 96
44 85
11001111101111101011101101110011aa111110111111110111111111111111110011111011111110111111101111110111aaaaaaaaaaaaaaaaaaaaa111011111111111111111111001100101111111
11101101111111111010111111111110aa11111111011011111111110110111011111111110110101111111111111110101101101110111111000111a111111111011110011010110000111110011111
11110101110111111111000110111111aa11111111111110111101011011110100111111111111111111010111111001111111111111111011100111a101101101111100101110110111111011111110
11101011111110011111111011111110aa11011111101111101111111111110111111101111111111111111111100100110111111111101111110111a111101100110111111111111111101111100111
11111111111111010111010011111011aa11111111111111110111100111111111111110011111110011111111101110111111110111000111111001a111111111111101110101111011111011111101
11111111111111111111011110001110aa11111101111110100110111111011101011101011111011111101111111011111111001101011111101001a111111011111001111011110100111111110111
01111111111010111111111011101011aa10111001101110111001110111011111101111111101101111111111111110011111111111011011111111a111111111111111111110111100110011011111
10111001111111111101011001010111aa01011111111111011110110110111101101011111111111011111011111011011111111110110110110101a110110111111101011010111110101111111101
11011011110011011111011101011110aa10111011110101111110111111111111101110110111111111111111110100111111111111011111111111a111111111101011111111111111111001111011
11011111101111111111110001111001aa11111111111101011111111111110110110111111111011001110111010001111101111101110111111111a011101111111111011110110110101111111101
01010111111111101111111111010010aa11111110111111101111011111011111111001111011101101101111010111110111111110111111001110a101110111111011111011112120020112002212
11011111111111101110111111111111aa11010011101011111101001110100010111111110111101110111111101101110001101111101101111111a111111111011111111111022222011201211212
01111001111011111111111111110111aa11101110001111101111101110001010101100101011101110101111011110111111111111110110100101a111111011110000111001120121212221111122
11100110001111011111111111111111aa01111111111111101101111111110111111110111011110111111111101111111111011111111111111111a111011111111111011102220120120112002101
01111101111111111111110111111011aa11011111111110111111101001101100110111011011011111110001111110011111111101111110111011a111111011111100111102121110102102012222
11011111110111111110111110111111aa10111111011101111111111111101111101111111011011111010111010101111001111011110110111111a100111101111011101110202112222112101121
11111110111111111111010111011111aa11011111111110111111111111011111010011101110010111111001011111111111111111111001100111a111111010011011101002221122211112122120
11011110101110110111011101101110aa11001111101010100111010101111111110110110111111111111110101001111001000111111011111111a011101000110111111022120121211022012120
11111101111101110011111011111100aa11011111110101011101111101111011111101001111101111011101101111101111110110111111111011a111101101110111111011211120011122222021
10011111111010001001111111101110aa10111110101011111000101111111110111111101111111111101010110100111111111111111001011111a100011111011111110101100222012002122020
11111110011101011111111111010111aa01110111110111110111111101111111111110011110011101110111111111110111011111100011111111a100101111111111110120012101111221002122
00101011001110111110011111011111aa11111101001111111011111111111110111111111101111011101011101110001111111111110111100110a011011111011111111121022021120022111021
11011011111111111110011101111011aa11101111111111110110111111111101011111100001101010111101111111100110110111101111111111a111011111111011101012211010111002022211
11011111111111010110111111111110aa01111101101111101111101111111101111011110101101111110111111101100111110111111110110111a110110111111111111012122100000211122111
11110010101011111011011111111110aa10111001111101111111111011111111111111011111011111110011111110111111011100010111110111a110011111110110111112011221210102121112
00111111101111111110011011001111aa11101111111111101111111111110110111111110110110110111111111111101010101111111011111111a110111001111111111001212222012221112100
11011001111111111111111111110101aa11111100110000011111011111100101111111111111111111111011111111111111010110111110111101a010101110111110111101111222212201011121
11111101101011100100111011111011aa01111100011110111111111111101011101111110111111111110111110110011001111011111101111110a011111111101011111010211200122211121202
00011000111111111111100010011110aa01011110110011111111111111111111111111111111100111000110101011101011111111101111111111a111111111111111101001102010220102011111
11010111111111001010001111111101aa01011011011111101011000111110010111121010120200202020201201220112111111110111011010111a111111100010111110122012221122112111012
11111110111010011101010001111110aa11111111110100001001111111111111111121122112110002112112112202111120011101111110111101a011001011111111111102212222122110121112
11101110111111100011111101101011aa11111011110010111111010111001011101110112012120112112221111020120121111111011101111011a101101111111111111102111200121111221012
10111101111111110011111101101111aa01110010111111101101111111111111101102201222120221211011110110011211110111101111111010a111101111111010101102112202012120212121
11111101101111111011111110111011aa10011110111111110111110111001011111112022021101211011110222111022111110101111111111111a001111111100111111112020201111122121010
11011010101111111111011111111110aa10001111011111011011110101100111111020211211220211222221101212121111110001111111111111a111111010111011110111120021111211211120
11101110111111101111111010111111aa11011110111111110010101111111111011111222112101210101202101011202220001100011111111111a110111111110111110111111112220220011201
11111011100101111110111111110011aa11100011110111111111110011011001111121222210111101122110221111122121111110100111111111a111111011111011111020112110112112222220
10011000111011111110111101111111aa10111110011110111100111111011111111101020010220210122222101012010221111001011101101111a101111101101011010011101002102212102202
11111011001111001111100110011101aa10111000000111111110111111111111101112220122212212211101021212222101101111010111111111a110111101111110110121220021201121112012
01111111101111100011010111111110aa00111011111111111111111111101110011120212021201111101020111211022211010110110011111110a111111111110011011111222022110202212221
00111111111110111111101011101101aa11111111111011111110111011110111111111022202212221012112222201112121111101110111101111a011011011111111100020011212211110022111
01111011111110011110111111111011aa10111111110001111000111111111111110122002120200202211212210202021210110010111010110122a122122212212210221200222211201111111110
11110110101101110111112111202112ba11212121121221201111101111100111111101012211201120211210111121221020011111111111111111a101011111022121221122121122010111011111
11101110001010111001110012120112ab10220201210111022221111110110100111112200112021111101011220122202200111111010111000022a201111212100210022220022122120111101201
10101100111101101111011221010111ab00210212102212211221111110110111111121011112122111010121102210122111111101111111111021a212220220221220022202222201211002221202
11111111010101111111111210221221aa21121020122210020201010011111001111120112102022202022021122121201221011110001110111111a222120100111002212222022222111011012020
11001111111111111010111001210111ba10012122021212222111110100100100111120211200221212112101002120000121100010010111011122a021102212212022100122222120220112222111
10010111111101011111111102220202aa22111222212211111111001110011010001021212212221011121122002000122101100001011111011112a202121212201022210222202222010021120202
11101111100111101100110012202210bb21022121220021110220001111110111011101211201022112111222202122100221101111111111111121a221212112102222020220222112211202110002
11111111101111100110011000022120ba22200122221210220110111101011001111122011211121220111222112202212201111111111110111110b010112221222122200212121202202212221022
11011111011101111110111111221222aa11122100011021110111110111101111011012001202220120210111110212101201101111111101110112b220202211112220212212200102102122002212
11111111111111110110012212222210bb12102120122111100011111111111111111110012121001021210100220210102111110101011110111102b222212111021222122222011222202001122122
11111110111011111111112122120021ab11111221010101200111011111111111011121122121200111021110212222212220111011111101110122b121220022122222111222222222202101210220
11111111011110100111101110112010bb12220101120222121121111111110111100002002222211121122111222121112200110110110111101122a200222102121202102122222122012112100212
11111110111111111111101122221011bb10122102211010121201111111111101111111111102212121221110011102212111001101111110101122b202021011122122221220221221012202212211
00110011101111111011112122011212aa01210101221121111111111111111111110021212220222212100122021221210211011101111111110002b211100020201222112011200222211220110110
10111111111111010110110022221122ab21210201011122212111111111111001111011201210120121102211222012001111111110110111111020a111102201002220120001021112221212221011
01111111111111111010102210111000aa12222121220011011010110111111011111120021221112212010122120111102121011100101111111110b120120221221212022202212222211120201222
01111011111111111110112220021002ab21220222211110211021111111010110010112222001210210111111212212100211011101111011100101b122011220022012022000112022210212220110
10111000111110111101112001102110ba12221221211022201221111011110101111111121001012101200020011222221221101111001111000102b222111102122220220222222022222102021122
11111111110111011110101111101102aa02112011212221110121011101111101111111101111111100110110011101110001100111011110110102aaaaabbaabaaabbbbbbabbbabbbbbabbbbabbaab
10111110011111110111111121102020ab112211122112222022210110001111111110101011111111111101110111111111011110011111011101211201211222112221211102222121222102210202
10110111111011010111100021112211bb122201210212212211211110111101111110011001111011011111111111101110011111111101110111011122012120111112012221220020222221200020
10111011110011010011112111212012ba111212112102122200211111111010111110111111111111111101111101101101111111011101100011211021102221110120212222202021102011201221
11101011111110111011112001121201ab222022210222002221111101111111111111111111111011011101111110101011111111100011111011200011220121221220220220222120212210211122
11111111111111111101111211021202aa020121112112111221111110011111111110111011001010111011101111111111111011101111001111112112012111220220222222120222222121021220
11111111011111101111110122020122aa022120010001021202001111111111111110110110111111100111101111111111111110111111101111222212222111210120220122220222222220011112
01111011110110111110112210112112bb121121010211201021211110111111111100111111110111111111111101111101111110101111111011212201102001010001122102022210212111111110
11110111011111110111012010201122ab121121221101121222211101101111111101100100111101111101111110111111011011111110110111000012211112002222222121122202222212112020
11100011111011110110102121011022bb112120122211210111111110111111011111011111000111011111111111111111111111111101101111111212102221011222122210110212201111111202
11110110111111111010111211211221ba111221210022110102111110110111101101111011111111101111110111110111111111011101010011002211212222010202220022222222222021202112
01111101111000111011112202122222ab110100211101222210111111111011101101111110100111111111110111111110111101011111011110111221121111012202201112222100212221222102
10110111111101111111110211020011ba212121111211111222111101101101111101100111011111111111111111111111011111111101111111101111100111111001212001210221012121111111
11111101111101111111111101111001aa110111111101100101111111111111111111110100111101111111111111111111111101110111101111111011111111111120112012222221220222121220
01111011111100111101100101011011aa111011111111110011111111100011110100111111111101111110111011011111101100111010101110111111011011110111111111111111111100110111
11100011111111001111010111111110aa111001111111011111111011111101111011111101111111101101111110011111110111111111101111101011011110111110001111111110011111101111
01101110010110111110111111111111aa110111111011111111111001011100111011101111111111101011100111101111111111110111010011101111111101101111110111011111111101011101
00111111000111111111111110011111aa111100111111101101101111111111011110011011111110001011111111111111011111111110111111111111110111111110110111101010011110111010
11010111111001101111011001101110aa111101111101001111111111111101011111110110111111101111111110111111110111110111111010111101101111101110111111111111010100011011
11111111101111111111101111010111aa101111111111110011100001110011111110010101111101101111111111111111010111111111111111101111111110110101101011111111111011111111
10111111101111111101110101010010aa111110111111011001011110111111101111110110010100001111110101110001111111111111011110111011100101111111111110110111110110111011
11111111110101000111111111100111aa01011011111110110111101101aaaaaaaaaaaaaaaaaaaaaaaaaaaaaaaaaaaaaaaaa00111011111111101110011111111101111101110111011111101101101
00011111010101111010101111101011aa11111010111011111111111111a010111010111011110010101111100111101100a00111111001111001111111111111111111110111111111111010001111
11111111011101111010111111101111aa11111001111111101111111101a101111110011111111011111111101111111111a11011111110011111011112222201021001100111212211021211111101
11111101111111100100110110110000aa11001001111001111111111111a110111111011111000010101111100101111110a11110110111100111010102112101210021211012101211220201011111
11111111111111111101001110111110aa10011111001111101111111111a110111111101111110111111101111111111111a11100101111111100110021100022220120012222212111122110111111
01111111111011111111100111010111aa11110011111110110110111011a111111111110110111111011101100111111111a11111111111101001101122201111121101202221210221210121111111
10111011110111111011111011011111aa10111110011011111011111011a110111110010110111110121112212102222221b11122121022201100111102212001222022111201121122122221011111
11111101101111111111010010111011aa01110111111001110011111101a111011011001111011111012002222221022112a12010101122211110110100122221112201111212100222211020111111
11100111111100111111110111010111aa10110111011101111110111111a110001110111101111112202220102102222222b00022202222200011111102221021212211210111111102202211111111
11011111111011011101111111101110aa11111110111111111111100011a011111111111111111110022102002222212222b02212222120210111011021222211111020010121210122210221010111
11111111111111110000011110100111aa10010101011011111111101111a101101111111101101112121202222202222212a02222221220021111111111110101211021222201002101022210101111
10111000110110111001111111111111aa10101001011111101101100101a101001111110111110001212100212111202121a11222222200221100011122120011112012221021221211102101101101
01110111111111011001111111111111aa11101011111101111111111111a010111111001101111011122221202202220222b12222212102221111111101011012022210220212022221221121111110
11101111101101101011110111111011aa10111111111111101011110111a111110111111111100011222210222012122122b02220002212221001011111210210212212121111222222122220101010
10111111111111101011011011101111aa10101101111101111111111101a111111101111111110101112122111200201121a22222022222000111111120021122002121121222202201212120111111
11111011011011111111111111110111aa11111001111111001110011001a011111111111111111012222022201220202122a20220022222211101111110110102221122112222110011002111101111
10111111110110100111101100101001aa11011111111101111111111011a111110011011111100112022202120211212222b20121012110211110110121212121201121220121211020112121011011
11111011101101101111111111011011aa11111110111111111111000111a110101001010000001111222122202022022222b20222121012220111111001021212000100100222222210012020001110
11110111111011111101111110111010aa11111111101111111111001001a101111111010111101112212222220012220111a20221221212101101111021120111002220221201212211101121110111
01111111111110101111101111111101aa11110111110111111111110101a001111110011111111110100222220222222222a20012222122120111111110210202112212212121202210112211010111
00011011110011111110111111110101aa11100110110111111111101111a101111011101111111111110122222102212210bbbbabbbbbbbaaaaaaaaaaabbaaabbaaabbaababbbaaabaabbaaaaaaaaaa
11111011001011111111011111011110aa11111010101111110101011101a101110111001110111100211212020222111212111222212120211101011120202202112122201222120121212221111101
11111011111011111011111111101000aa11111111110111111111101111a101110111110010111000212222220201210010200220122222211100111000211212121102112102112121222121001111
11110111111111011111011011111110aa11110011111110111011111010a001111111100111011012121122022212222202002220212211211111101102122111020110210210112200212111111111
11110111011111011011111111111111aa10110111101111111011011100a001111111101110111112200202222220210021021212012220221011110102111222020222120201022121211110010011
01110101011111110111111101101111aa11111001110111111111110101a111110111101111111102210011222202122212002010222222121101011000210012220011122211210210022121011111
11111101111001011011010001101011aa11011111110111111011110011a101111011111111111111022212020220222121122202200122001111110122121212221101120210211112112211011111
11111111110010111111111100011001aa10100111110110111111100000a111111011111111011111021220022011212021122222120222101101100121211112221122012112120121222001111110
01111111111101111101101110011100aa11111111111011101111011110a101110011111111111112110122212211210211120222002022210111100120001212221022022222201221112111111111
11101110111111101001101111010111aa10111111111101111111111001a011110111011100011101222211212102202000112222201221121110111020020201110210211211112011212210111111
10111111111111011011110001111101aa11111111110101111101111100a101111011111111011110222221022012012220222210122210001001111121222111121201222202211220211211100001
10111111100110110111100111101001aa11101110111111101111011111a010111110011001111112122022120202212012220002221220021111111011102121121111111111212011212021111011
11011111111111110111011111111010aa11111111111111011101001111a000111101101111111010001222122222022221222222222021211111111112201220201002221100012210121011110111
11011100011110101011101010110011aa11101111110111111111111011a111111110101110111011012022202120220010120222200222121101110101111110111111111011111111110101001111
11011011111110001111001101001111aa11111111101011011011111110a101111111110111111112122222220222222221200202222122221111111111000111111100111110011101111101111111
10101101111110111111011110011111aa11111111101101111111111111a101111010111111101102220222020122122221122121221220221111111101111111111011111111111011001111011111
11110111111011111101111111101101aa11101111111111011110111110a111101011111110100111012202001210222222202221201212211011111111110000111111100011011111011101001111
11111101101101010111110110011111aa11111100110110011101111111a111111111111111110012111112102011012111112111012122101111101101101111111101011111111110010110111111
00111110000111011011111111111111aa11010111101011111011101111a101111111111111001012220021221020001212210020211101111110111110111111101101111111101110111111110010
