10 15
1 148
96 118
23 138
107 65
40 143
85 26
57 1
111 128
33 116
1111101111111111010110111100101101101111111111111111111111110111110001010110111111111111110000101111111111010110010111111010111100110111111101111111011111111111
1111111111011011010111111001101101111111101111111111111111111111111110101101111111111111111110111111010111111111101111011101111111111111111111111111111001011101
1010111110000011111011111111110111111111110111101011010011111011111001111101010110011111111011111101111111101111111111101111011111111011010110110110011111111111
1011111010111111101110011101111111111111111100111110111111101111111011110011110111111111111100111111111101111111111011101111111000111110100110100001101111110111
1111100111111111111111111011111010111111011101100111101111110111111111110101010110111111101111101111011111011111101111000001111110001110111101111110110001011101
0011111111110111111111011011111001111100101110111111111111111111111111110001111011111111111101111011101111110111111011111111110111011111111111110011110111111110
1111101011111110001001111111111111111111111111001110111001011111101111101001111111101101111111111000111011111111110110101111111111111001101111111111111101111110
1111111111010110101111011011011111111101111111111111011101110011101111011011110011111111111000011110111111111111111101111011111110111101111111110111111101011110
1110111111111011101101111011111111011101011010101110111111101111111011110111011111111101111011111111101111111110111011111112101221010201022112102202101002010101
1111100011011111111111110011111111111110111111111001110011011101110110110001111111110111011111111111111110111111111111111111001220111121212202121021001210110011
0101110101111101110111111111101111111110101111111101100111101011111111011111101101101011111011110111111111110110111110111101112212210001110222212102212222011111
1101011111111111111111111110111111101101110111111011101100111010110011111101110111111111101101111100111110110110011001110111102002211211211121021112100001110011
1101111110111111111111110111110100011111111110111011101011101111101011011111010011101100111011111111011101101101101110111111121220221120022212121020201122110011
1011101101111111101011111001101111111110111111100111000111101110111111101011101110111111101110001111111111110011111011011110202211220121220211120221210202101001
1110110111110101110101110101111101111111100110010110101110001011111100111101010110111110111101111110111111101111111001111112100120120212111010112022122101010110
1111111111111011111111111110011111011011011111111111111111111111111111101011110011111001111111111111011100111111011110111110200212221011020211120221222222011111
0111111101111111110111101111011001110111011111111001110111111111111111101111111100010111011111100111111011111110111111011100112012202211012222011011100221110111
0011111110111100101111111101110111101101111111100001111111011100111111111111111110111100111010100010011111101111111101111012002211211002122112222111201102111111
1111101111011111101111101111110110111111111011111111110111101011111101000011111111111111111111011111111222010012122121112022002102222210222120201112200121110101
0111111111110111000111100111011111111110111111111111111111111011111101101111110111111111101100101110102112122112102122120122220220221021212220111121011020111110
1111011111111111111111111011111111111111111111111011111111110111011111111110111111010110111110001111112111101122111212011010022122222222212212021212221100111101
1101011111101111111010111111010111111111010001111110110111100100110111101111100111111101101101100111111121011121121112210122212211211022121012111220122001111110
1111110011111111111111011100111110111101101111111011111011111010010111111001110101111111100011111111111111111211200022212002222202220221122212222101211211001101
1101010111110111110111110101010111111110011111111010111111011001101111110111111111111111111110101111111222100122221102122112211211112112212212121222221121111001
1111110101111011011001110111110111001111011111111110111010111111110111100010111111000110100111010110121021111112011021012222221202221212201220222110210002011101
1111010111111101011011001111111101110111111110001111111111111111111111111101111011011101110001111111110122212121221112201222222120200201222222221222122200220011
1011110101101111001101101111011111011111110101111111100111110011110101101011111101111110111011111011111212111101100212202212212102221220211212022212221202211201
1111111110111001111111101111101111110001111111111111101111111110001111111111100010111101111111111111122121022022120212101220212222211202022122212122222022101120
1101010001111101111111101110111111111101111111101111001011111111111111110010111110111111111100111010121121212002220221211221222222212202212211122212222201202101
1001010101111111101111011111111110111011110110111111111101101111111101110011111111011111111111111011121210111111211121121022022122022222221222221020202222110101
1111110111111111100010111001111111110010101111011111111111101110011111101110111010111110011011101011121122101221211221010222102222022122220222110221002220111201
0111111101111100011111011111101100111101101110111010101110111111110011111111111110110011111011111111121112011201122221122211222221220222020222220122222222222121
1111011111001101101111111111110111111111110111111110011111111111111111111101111011111111101111000011122122221010222102122222211220222221210212221222002012110111
0111001001111111111111110001011111110111111111010111111111111111111110111111011111101110101110111011110122111112121202110111120022022222020122122121222220120021
1011101010110111111111111111111011111111111111101110100111111111111111101011111011011111111010111110102020212112110121122021012102022222212122112210222220212121
1011111100111110101011110101111101101001110111111111111111101111111111011111110111111111011111111101102021210122121012212112201210202022122002122112012212212100
0110111111111011111110111011111110101111111110001111010111100100101111110111111111111111111101111110011111221210212220110221122202000220010212220222212002111110
1110111101000111101110111111011100011111110111011111111101001111111111011111110111010111111011110100001122111110221021021122222022212202220220222212201101001001
1110111011101111111101101010111111001111101110111111101111011101111101111111110011111111111011100101112212212102222211122122201122202220122222222212212222201011
1101111011111011011111111110000011111110111011101111101110111110001010110111110111111111110111111111112112220101200001221100011020122111020010212010201020112121
1111110101111111111011111111110111101011111111011101111111101111111011011110100100111111111111111111121220022221111211210012110012221222222000022101220221220011
1111110111111111111001111110111111111111101111100111011110111101111100111111100111111111111111111111120121120001222112112112021102120212112001212122010212211201
2110112122210021211111011111111111011110111111111111111101111010110111110110111100011111111001111111122112122120012222222110121202201112110020021222212220101111
1101212112212112110111101101110011110100101111110111011110111011001100010101110111101111011011101011112212222111120111212212121222012012021002211212222212111011
1220111010101202211100111111111110110111111111111101111001111111111011111110111001010111111111111111112102211211211122221202100022000102000110212122211002112211
1202220222212111110111111111111110111111110111111111111111110111100011111101111111111111011111001110111110211010222111102112120122020221222021001120212112221210
2100111222012121011111101101001100011111111111111111100110111011011111011011111110111110110111100011121220020202121210221122222002121120111222222222020102202120
0220112110122012111011110111111101100111111111001111111111111110111010111011111011110101101111011101122202121012202202201200011222222021111222212020121221211111
2002111021212221111110101111111111111011111111111101110111110011111111110011110101111111111111010111121201120002111121022221101002101222120001212202221201212101
0112122211111212011111110111111111111111110111110010111111011111011001111111111000111111011101111101110101110010111100001100101112211221022222221101121212120200
1110012221122002111111011111111010110110111111111111110111011011001011111111111101111011101111110101111011111111110111111111111101211202221121121122211111001211
0220221222122010000111110101011011111111111011111110001111111010111001111111111110111110111111111110011111011001111110111011111111201202122022212111102121221211
1011022212221120011110001011111101111110111101110101111111111111111101111011101111111110111111101001111101100111110111111111111011001201111212100111101111012020
1111112022021202111010110011111011000111100111101011111111011110010001111100001111111110111111111101001100101111011011011011101120112021121111221021012002120220
2021112121101122000011111110111111011111111101111011111010111101110110110101111111001111111101111111011111111101111111101111011111220012222221221211220211202101
0110022021222222011011001111110111011111111111111010100010110111111101110110111110110110111100111111111111011111111101111110111121110100202221101112012221221021
0102002001011220211111011111100110111111011111111011100111001011111100111111011111111011110111111101011101111101111110101110101101011011111111111111110101111101
2012212222121110010001110111110111011110101101111111011111110111101111101110001111011101111110111111011111011011111101101011110110101111110111000110101101111111
2011002111110211110011101000011101111110111001111110111110110110111111110111110111101101110011110110101110001111110011111110101111101011101100111100010110110001
1122102002112111101111111101101111011011101011110111111111111101110011100111000111111111101111111111111111011110111111011101111111011101111011110111111111101001
1111121122221121111111111111110110001111110111101001101011111110101011110101101011110111110110110110110111101101011111111111111111011111110011111111011111111111
2112011222101202111111101011110110110101111111110111111101011011111110111011101111010111011111111111111101101111111100111101110111111111101101101111110111111111
1222110121011211101110001111111111111101111111111111111001111011011110110111101111110111001011111100000110011111101111111111110111111110011111111011111110011111
1221222022221112211111111111001010011111111111111111101101101111100011101111101101101111010111110111111110011111101011111111111111010100111111111101110100011011
2221221111220021111011111111101101111111101101111110001110101111100111111011111111110110111111100111111111011011111011101101111111010111111111111111110001100011
2212101222101111101011111111101111111110011111000011110111111101111101110111011011110011101111110111001011011111111111010111111111101111111111111111111100111101
2222112200201011111111111111111111111011011011110111101011111111111110111110111111101111110111001001111011110111111111001101111110110110111111111101111111011111
2021221121122222210011011111111010111011111111111110001011111101101111111011101100111111111110111101111111011011111111111111111110011111111111110111111110101110
2121022212112221111110111011010111110111011111111011101111111110111111111000111111101011101100011011010111010001101011111111111011011110111101111011001101110011
0001202021110120210111110011011011111001010101111011111101111101101111110101011111111101101111110110001111111111111111111110011011111011100111111111111111111111
2102112120122222021022102102111221211001121001111110110111011111101011110111111001110110111101111011111111110101111011111011100101111111111101111111111111110100
2100112002222202121102212100021222211200101111101011111101111010011111110110111011111011111110111110110111110111111111111001101111111111111110111111011111110101
2210101112122122001222121100100010221212101001011111111011110101111110011110111001110111110111111011111011111111011111111110111111111110011111111110010101100110
1011110111112212120011022020202221211101101111010111110110111101111111011011001001100111111111111011011001111110000011111110111100001111111011111111101110001110
0111101111111100212020102011111111012211021011101111111010111101110000010111111101110111111111011111111011111100110111111110101110011110000011111111111011111111
1111111111111101110222002111020201212021011010101111101011111111111110111010110110011111111111111111010111111111011000111111111111110111110111111110011110010111
1111010111122112000110011111021112212211121111111111010010111111111001101011111001111110111111111111011111111111111011110111011111111001110110101110011111110110
1011110111101212220022011202200222211122201110100110110110110111101011111111111011111101011101011101111111110011111010111111011010011111011001111111101110101111
1111110111000222202111020122211112110220201110111111111111111111111111110110011011111101111010111111111111011110111111110101111111111111110111111111111011011011
1111101110120122212210111111211012211001221110011011101111000110111101111111111100011111111011111110011111111111110010001100011011101111111111111011111100111111
1111011101112021212121121212222101112212211111101111111001111111101111101110110111111001010111101101111111011011101111110001111101111111110111111111110111111111
1111101100112101012021222112121222211110011111111011011110111111111110111111110011111011101111011101011122001002011210210122102210212011111111111110111111011111
1101111000101211022101222111012011112202110100001001101010111101111111101110111110111101111111111100011012212220221121222102121021102111010111111110111110110110
1111101111121211212221121222022022121110011101111111010101110111110101110111011011110001111111010101111112121111210120222010011111221101101111101111011111101111
0111111111112011211121212112011221221222121111101011011111111011011111001011011111111111011111101111111012210011112112120220121110001111111111110111011110101111
0101111101112112020220111021120112212122111011100111110111011111111111110111110110111110001011111011101221221111112200211221212112102011101111111011011010110111
1110010111022211220221201212102110010202011111011111111111101111011111111111111111001100111011111011101101022101200102202111102122021111101110110111011100111101
1111111111122122102012120221222000121111221111111010011011011101010111111111111011111111111111111101111101211220012121112222211211020211111111111110101111111100
0110111101100201110021120010012111102100121010101011001111111111101011110011111111111101111110101111111210010112011122222022220101210211111111111111111101000011
0100011111022212211212210122211120110020211111111010111111101111110111111111001110110111111111010101110121222121021111012202221222122111110011111111101100111111
1111111111121111212212112220211110211222101111101100111010111010111101111111111110111100110011110111011111201212222111201202012002001101111111111110100101111011
0011111100010221001221222211122211212112221111010111101011011111001111111111110111111111101111111111111121210221112212011122112220211210111111011111111110110111
1111111111102122112101021121221121211002221111110122221212211121222121211121201121111110111101111101011210110211110120111120122020221211111101111101111111111111
1101111111110222021101221220222211022100111111111010020212122220212221212002110211011111111111001111010101112222122222020121011202221111111110110110111111111111
1111011011112001002111221100212212221220121111110102012022111111021011201212112211111111111101101111111112222202011012220222211121112111111101011100111101110000
1111111111021112100111001202112122211210201110011120120101122101100110222211201220101111111111111011101112102221221201010200110121022011011111111111111111111111
1111101110120000112121121220112110100121211111100102021102010202221222122210210221110111101111111111011212011221102201020222222222222212120111221111111110111110
0011101111102020202221101221121112010222221111101111012012221121222120220022100221110110101111011111111120021012212222212012222211200211012121101111011110010111
1011110110011212211110111122212112111120021111101112222122122022021011002111110210111101111011111111111021012221121022112220222121002012210112110111011011111010
0111010101021212212222222110120220021212121011010021110020200121221121221121201121001101101011111111011211011101122120222221202202102221101211101101011110101111
1111111011121102010022111122121110022012111011111111021011222022120211020020221111111111111101111111110110212022102002220200011122102222211210101111111101001111
0101110111110111111111101111111111011111100010011122021221112210000202012002001121111111111101111111111222222210222200022121202221202200120101021110110101111111
1111111011111111011101111110001111111100011110111122021120001211221001102001012211111111111110101111111112101222002022222212002022220211022211211101101101110011
0011011011110101111110110011101101111111110101111001211011011112222222220101212200011010101110111111111122221122210020120012222222212202011022221010111010111011
1111111110111111101111011111101011111111111110111111122211211112211201011202212001111111111101011111101222112222122021222222212022122222120121211011011111111111
1110111011111101110111110101101110110110001111101002010221210220020202022201010121111110111111111111001210111020110220221012222210220012111120110111111111111111
1011111111111101101111111001111101111111010011111122112202122021122021222220221220001111111111110011111121221211022202221221222222210211100110111101111110111111
0101111111111001111111111100111111101111011110111112012201012212102012222212210221110111111100011111111122221222022212022210001020222010211221021111011111111111
1101111111111001111111111111111101110011111111111022212011122200021012012122012111111110111101100111110020202121222022002110121201202211211212111011000111101111
1110100111111111011111110111111111111111111111111111212210011201122121111221122211111010111111111111110200022111220101122102102020220111112010121010110101111111
1111111111111011111111111111110011100110101111110121222110220211212111221110202201011100011000110110101112101121112221222210021022222202221111221111110011111110
0101101111111110100001101111011101111111111111111101221112211212000102122102122121111111111111111011111021011112122000022112120222121210221112211110110101101111
0011011111111111111111111110111111011011111110101011210112102121201201202221111111111111011111111110010111111101120221101110002112222022011121111111111011111111
1101111111111011101111101111111111111011110111001011112120211012222001022202121101111011111111111101111110011111111202121201212220122102200212021111001111111111
1001111101110011110111101111110010011111001111011112112212222222122222212012122210110101111111111101111111011110112110010122222202212210121220011111100110011111
1111111001111100110110111111010111111111110011111002010210102212111220022210000221111111111110111101011111110111111212012210221111110122222011221111111101111001
1010111001111111111110011111111111011101101100111121002022211100122011022002121101111111110111111011011101011110122222201210122200200202122021100101011001011111
0101101001111111111111111111011111111101101011011111111121222200122122112011021211110001111111110101110111111111121211200021212202122222200112211111111111101111
0110111111111111100101111101111111111110011111010120211111101212122120111112221211111011111111111111110111111010121202210212011121222112111112111011101111111111
1011110111111110111101001111011111111111111101111100211112221101120221200111210021111111101111111111011111000111121121211021021220202201212211101111111101111110
