16 17
14 157
70 62
7 134
56 120
28 107
110 23
66 65
90 127
56 101
1111a01011111010111101011010101111111111111111111011011a10110111010111111001111101111110111111110111111111011111111100112112002021012011222212111112201111111111
1010a11110111111111111111111101111110111111011011111001a01011001111111111111110111111111011011110111011111010111111011122112200210122000101121010110211010111111
1111a10101111110011100110111111011011101111111101111110a01111101100110111111111011011101011000010100111111101101011111101102211020210100110212221210221111011101
0100a11111110101011101111111110111011111111101011000111a11111011111111111011100111110011011101101010011010111111011101112111110000112222201012101212011111111110
0101a11111111111010101110111100011010111011101111101111a10111111111001111101111111001110110111111101111101110111111011002221011101112102221122010201111111110110
1111a11111101110100111000111011111110111111111000110011a11111111011101111111110101011110111111010011111111111101011111112121211122112112221101111111221010111111
1111a01101011111111111111010111111111111101111101101110a01111110111111111111101111101111111111111111110010110111000111122012111212222121121221220221211111000101
1110a11101111010110101101101111101111011111110010001101a11101100111111110011111101111111111111110101010100101101111111110212211110210120111122222211221111111111
1111a01011111111110011101111111111101111110111110111101a11110110111100111011111111111011111111111111110111110001110101112122212121121121122112020121211011111111
1111a11001111101101111011001111110111101111111011110111a11111101011111111010111011111111101111111111111110111101111111001121110222100112001210222120111111111101
1100a11100111101111111111111111110111101101111011111001a11111110110111101111000110111110011111011111110011011111111011111101021122211021221212210221100101111111
1000a11111111111101101101001111111111111101101011101111a11111111111010110011110111101011111011111100011111110011110111112202021200222111010121201122221111111011
1111a11001111111110111001101111011111101111111011101011a11111100101100101110111100111011111101101111110111101101111011022201200111101102121120222201221111011111
0111a11111111111110011001101001011011111001111110011111a11111101000101101111001101011011111112122121120211001212020201222022121221101111211122211000220111011001
1101a11111111010101111110101101110001110110110111011111a00100001111111110100110100101110100122001121001200122211210200102212220201110220201121111222120111111111
1111a11111101111111111100111111110111101011111111110111a10111111101111111101101001001111110102200020110221122220101011222022112220101110221221201212111111111111
1111a11110101110111001111111101010111111111101111110111a11110110010111011110101111111011100112102112101020211112222100022221112001120001211212112021211111011111
1010a01111111101011111111111111111111111111110101111101a11011011111111111111110011111111011112211122221212100120201211212212011100222110102111121112201011101111
1110a11110110111011001011111110111111111110111111101110a11111110110111101111011010111111111100011221112202212111101211222101212002212011012201220222201011011111
1110a11110100111010111001101110111110111000111111111001a11010010111111110011111111011111011101012110220100121201121111220102102222110010120120201222021101100110
1101a11110111111111111111011111111111111101111110110001a111aaaaaaaaaaaaaaaaaaaaaaaaaaaaaaaaaaaaabbab111222201011022112001021012222122112121120222221221011111111
1111a11111110101111111111101011100100101111011110111101a111a111111111111111111011111111111111012112a201200021202221120101210021222102220120210111001121011110111
1111a11111011101011011011111111111111011111001111111111a111a010111111111110100111110001101111122222b122201201122011202101121212122211121002022121100211001011100
0110a11101111111010010111111111111110111111111111111011a111a011111001011010111111111101111110122220b021220122121102212121211111101111111111101111101111111110101
1111a10001101110111111111111101101111001111101111111110a101a101100101011111111010111011101112112002a202221122120102112110201000101000101011111101101100111110111
1111a11101111011111111110111111111011111110111100111111a001a111111101010111111111111111111002121021a101101200012020202011111100010111101111101101111101100011011
1111a10111111111111011111111111111111111010111111111111a101a111010011100001111101011101110111122202b211100212022100122102211111101111011111101111111111010011111
1111a11111111010011111110111111111111001011111111101111a011a111110111101001001101111110111111222200a210210020200211220111111111110011110110111111111111111101111
1111a11111011111111001111100011110111011110111101011111a111a111110111111111111111011110110111112112b111121002222122222121220100101111111111011101111111111011101
1110a11111111111111111110111100111010111011111110011111a111a111111111111101011111111111111112022121b122212222211221011122210110101110011101111011111010110000101
1111a01011101110111101011011111011110011111111111111111a101a111011111101011011111101101101011210202a112120122000112200210111111101111110011110110010010111111111
1101a10101011111111110111111111111110111110111001011111a111a111111010111011011000010101111112211101b212001100202212021112211110111111111110011111011101011101111
1111a00111101111111011111011111111111111111110111111101a110a111101011110011111011111110101012101112b121110022112122210212101111111111011110110011111110001110110
1111a01011111011111111111101111111111011111011101111100a111a111111111111111101111011001111112020100a010110112112111012221011110101111101111011110110111010110111
1111a01111011101011111111010100001111101000111011111101a111a111110111101111111010111111100111221222b011112122112001211112121111111010111111011111111110111110100
1110a11101011111111110111111111110011111110110111111110a110a101111111110111110111111111111112122112a110112111110110121221210100001110011111010101111011111101111
1111a11011101110101111111111101110111001111111011101111a101a011111001110011011011110110111110112222a110222112212212110210011111111101111111111101111101111110010
0101a11111111111111100101111000010101111100111111111111a111a011111101001001001111101111101112120102b222022220001111002000100011001110101110110001111101101001111
1111a01111111111111111011111011011111110111011111111111a011a110011101101111110001101111101000110110b120120002201102100001011111011010101111111111111110101100111
1111a10110101100011111011111110111111000011111111111101a101a011011111111111011111111111110111022112a112211001021121000212011100010111111111111101110101011111110
0101a00111111110111111101101110110011111111111111101111a111a100101101111111111111011111111111011200babbbbabbabbbabaaabbbaabaaaaaaaaaaaaaaaaaaaaaaaaaaaaaaaaaaaaa
0111a11100111110111101110010111011111111100111011011111a111a1111110111111010011101111122112121122202221222222222222220222122122201211112011110101111111011011111
1001a11111111111111111111110111110110111111110010111111a111a1111110011111110111111011100221102021222222222221020222212221222110112101202110111111100111111111011
1110a11011111011111001101110111111100111101111111111011a111a0110111111111111111001101111111222021212202212222210120221211002202222222001111001111111111111111111
1111a01111111111011010101111011111111111011110111110101a111a1010011001011101111101111112102222211211222211122200202120220122020021011211111011010111111111011111
1111a11111110100111111111111100111001110111011011111111a111a1011111111101111111101111122000010221210011212202122200221022022222122012000110011011100101011111101
0101a00111111111101111010111010111111100110100111111111a011a11111111111110111001100111111222102011200122222200221222222110022121110010010110aaaaaaaaaaaaaaaaaaaa
1110a11110011101010111011111111111111111111011111111011a111a01111100111101111101111111001111111102021111222221220022211001212110122112001111a1110111101011110111
1111a11111111111111110111111011011111011101011111101111a011a11011011101110111011111100111221011002222201212212022212011021212221222021111111a1010111111010110011
1110a11111011111111111111011111111110011011111111001111a011a11111111101011110100101111110111020201112221020212221222010202122012102212221111a1101001100111011101
0010a10111011111111111101111111100111111010111101101110a101a11111111111110101111111111021111100021011212102012121220211210120022111122211011a1111101111101110111
1111a11110111011011111111011111011111111111111110120021b121a11021021121221202200110011211121022111200111211122122211012202102222211022021111a0011011101001001011
1101a01111111011110101111110110011111111111101110122011b111b21111111110120122020211101121022110200021112212222122222020121002001221121111011a1101101111011100111
1011a01111110111111110100111110101111111111110111010222a001b11221012010121222010100111202101211221121012221121122200111222110201021111220111a1111011011111111101
0101a11101111111000101111111111110010111111101111110112b121b02102222222112111212111111120111221211001021200210002220102012020202111101211111a1111111111110010100
1110a11011110110101111111011101101011110111110011122200b222b20222022202221221212111111220101211111101111122122220220222111012000211120121110a1100111111111111111
0101a11111111111001111111111111111110111011111122122022b222b22002022000011222211211101212222121220220020012212222022222222021212221111211100a1111111111111111101
1101a01101111111111101111101111110000110111101022122212a222b00022222222022212201111110212222121211010021120212200121200222101102021011221101a0011011111110011110
1011a01111011011011111111111110111100111101111122120212a222b21121201202212212120211111102110022122111110122222202021201102012222110011221101a1110101011111111101
1111a11101011111111101011101111111111011111111122111122b002b20120222221221222211210011112101110111220120122222212210202121200221112111111110a1111101011110110111
1110a11110011111011111111111011001001010111111120011122b222b00122222222202222211111111221002002101022110120220202202221011212210211100110110a1110111110101001110
1111a11111101011110111111111100111111110101001012122220b000b10022210222222102120111101102122200112221122222220200122211222121211011112221111a1111100111110111111
1111a11111001111111101111001111110011111011011101122222a212b12212212202222222222011101022121101221212112222221200000212222222111022022201000a1110011011011111001
1001a11001101110111111101111011111110010011111010102022b222b22120121210220020211211111201111122100201121220222221022011222011101212110121010a1111101011101010111
1001a11001110110111101001111101101101110111110111110222b002b21022002121200202200110110110202211112101222222000220021120221112001102102011111a1111101101010111111
0111a11111110111011110111111111101111111111110121122200b012b22102200122202222212111111220122100212000100222022022211220111022221021021221111a0111111110111111111
1111a11111110111111011011100111111111111111011122201202a222b101221222222221212120111012102021202201101122212222202022100babbababbaaababaaaaaa1111110101101101111
1111a11110111011011110101100111111111111011111122120220b121b120220020221222022121111112222102002221201111212122120120111a211211201211210111011100111110111111101
1101a10110111110111111111111111111111111111111111122212b011b012222002222212222110101002211200001122011110222022220012122b122100202121211111111101110110111010111
1111a11111111110011101111111101111111111110111110021122b012a222022222102022212122011112212120110001210201000111222222102b101002221221210111100100111101110111100
1111a00111001111111101111110111111111111101111101122222a012b001222022212022220010111102012122011202212122011202122112112b110021212110110101001111001101111111111
1111a11111111101011111111111111111101110111110102221022b221a221220211210000222210101112101001112021201022212221222122201b020021212211020111111111111111111101111
1101a11111111100111111111111000011111111111111121202111b212b222120222220222202220111111100101111100111111111111111111111a011011101111001011111011111111111111111
1110a10111111111101111111111011111101010111011012212222b210b000212221222221002221111010011111111100111111111010111011111a101111011110111111111101101111101110111
1101a11111111001111111110111111111111111110010001220210b220b200201222220002101021000011001111011011110110111111111011101a111001011100100001110110111111011110111
1111a11001111111111111111111111111111011111111110121220a011b222212222212212222010111010111111101110110111111011122222121b111222002022211210201111011110111001111
0111a11111111111110011111111111110111111111011120222222b220b222221101221021221202001110100110011101111111111111102112222b010211112021121122200111111101101111111
1011a10111111111111111001110101011110101110111102122022b222b220012222222012212021111101011100110110101111111111111101120a212120211122020112110110101111101111011
1111a00111111111111101011111101110111111001111001221212b221b120222102012022221121110111111011111000111111111110100120012a122222111221222121210111111111110111111
1101a01111111011110110011011100101011100101111021222011a022a221220221111000021121111111110000110000011111011110011111012b112120002221001101112110101111110111001
0110a01111011101111111111101001111011111111110121102222b220b212002222110112102112110011011111111111110111011111120110210b111122220000210212112210101110111111011
1111a10111111110111101101111101111011101111110111201122a202b112022022022101002012111111101001011111111111111101112000210b202010220222101121112211111111111111011
1011a11111111010111111111111111111110111111011122221111a011a102110022122121122111111111011111111001111011111110112112211b122112121121212212111201011100011111111
1101a11011111101011011101010111111111111110111101100010b211a221221211111110212110111110101011111101101111111101101110212a021011220212112121110211000110111011111
1011a11101100110110111101111101111011111111011101022121a220b011101211201221021111011111111111101111011100111111110210212a221202011011201112012011101011101011111
1111a10111110111101110111111110111111011111111112001012a202b210101111201020102101111100110111111111111011101111111121022b201211212012120220012211111111110111001
0101a10111111111010011111111101111111111011111101010010a101a011011011111111111111101111111111111101101101111111122121122a220220202122011221220200101111111110111
0110a11010011111100101010111100111011111011101111001111a101a110010110111011111010111111111111011111011101101111122212221a112220202112102222211111011111111011111
1111a11110111101001111011110111111110011001100011101111a000a011101111111111001111111111101111111101111010000101120001011a021111212212121112210011111101111111111
0111a11111110110111010110101111010110100001100111110111a111a111110101110111101111111101111111011111011111111111021022212a221220112210222220210010101010111111011
1111a01111101110101110111111111001111110110110111000111a111a011010111010011101111011101111111111111111111111001111122111b111012102102012210120211111111111101111
1111a10111111111111110111101111111001111101111011110111a011a011111111001111111011111111100111010011111001111010121111112b101011220102201120212111100100011011010
1111a10111011111001011110110110111111111110111110001110a111a111011111001011111111111101101111111011110111110111112102122a022200111201010221120211110010101110110
1101a00111101110101111101110101111100111111101101110111a110a110111111111001011111111111100111111101111111111111002212120a221012012201111221002001111011111111111
1110a11111111101111111111101011001110111010001110110110a110a110111011111111011111101110111101011100110111111111102112021a011211211222022122200111011111111111011
1011a11122112111120011212211121100011211111110111011011a111a110111111011011111111001111111111101111111011101110110011201b202201222202110110210211111111111111110
1110a11112202012122111212022100112112011100011111101110a110a111111011100101101111011001110011111011111111100111102122220a201111220121022110121011011111001110110
0011a01111010200101012222122220220221121100100010011110a101a001111101111111111100111111111110111111101111111011111120122b211122122022102022011111111111111101001
0111a11121110121122210020122211012111221011011110111111a101a111111110110111011111111010101111101011111101011011112111122a200001112102012012222111111001101111111
aaaaa01012121212211101222122112122122211111111111110111a001a011001111101011111111111111010111101111111111111111002112221b112022121221110211002001110101111111110
1111011121202110112112110212000010021000001111111011101a111a111011111000110111111111101101111101100011111111101120111101a222021221221121220201111100111111011110
0111011100102211022010222010100122212121011111101101111a110a011110111110111111100111111101111111111001111110011111010221a001111121111110021111011111111101011111
0111111122001212121201011200122122112200111111111111111a010a111010111111111111111111101110100111111110110111111122020200a121221110022122211111101110111011010001
1011101122221211002220212221222222122121111111111111111a011a010111110011100110111101011011111111010101011111111121201212b022110121111101222121111111011111111111
1001111120022212121001222212222112121211011111111001011a111a111111011101111111001111111111100111011011111111011122221112a221212212121101100011011110000111111111
1100111121212122222012110221102111220101110011110111011a001a111111111110011101011100111110101111010011111001111112120112b211000021211101121122101111111001111100
1111110102101112221222120112121220100001111010101111111a111a110110111111111111101111101111101111101111111111111111011111aaaaaaaaaaaaaaaaaaaaaaaaaaaaaaaaaaaaaaaa
1001111111211122012201200102121222222000001100110111111a111a1111110110011111111101111001111111111110111101110111011111111111011111110011111110011111111110111011
1110101122221210102102212200011221022211110101111111111a110a0111111111110111011101111111111110111101111111111111100110111111111111111111111101100110111111111101
1111101120211110011211222212112011221121101101011111111a111a1111111111111111111011111001101110111011111111010111111010101110011110111111111111001001111111111111
1001100102112220221211211221120222220110011111111011111a111a1111110111110110101111001011101111011111001111110110110101001110101101101111111011111101101011001000
1011111120110101122222021121011210011111111111101001101a110a1011101111001111011111111101111111000001111111111111111111101101011101111011111110011101111100000001
1111111110212021011212111212200210222121110111111111111a110a1110011110111011111111001110101111111011011111111011111111101101011100111111111111110110111111011111
1111110021021012001101021221200020211101111101111111011a100a0010111111111000101110111111111111111111011111110101111110110111111111011111010111110110011011110110
1110101102122021210112221222221102121211111111110111111a111a1010110111010111111101111101111111111110110111110110011101111101111011111011110110111101111001111001
0111011121001222212110020121122211112111001011111111111a101a0110111001001100101111110111011111011111100101111011111111011111111111101111111101111111111111101110
1110111121212122222112101011012021211100100111101110101a111a1011111011111110111111111111110110001111101111011001111111111110100111111111101100011100111111111111
1111101120211121221211220112012111122221001101101101011a101a1101110111011101010111111111111101011100111111011011111110001111111110011110111111001111011111111110
0111100111121221111202012022220011022121111110111111111a101a1101011111110101011010111111101011011111100111001111111111101011111111111011011111110111111011110111
1101111121101022221220112011111221121210111101111110101a111a1101111111110101111010110111111100111011110111011001111111111101111010111001111111110100011011101011
