104 4
16 157
73 2
58 71
111 78
57 9
71 93
87 144
107 153
66 36
1100111111101011111001100111110111011110011111100001110111011111111011110101101111111111110111110100111100111011110111110101111111111101111011111111111101111111
1111111110111111111101110011101101011111010111111110101101010111101111111111001010110111110010111011111101111110011110110101110111100010111111111110101110111111
1111111011111111111111110111101110111111110101111111111101101111110011111110001111101111011101111111111111111011110111111101110101111111110011101011100111001010
1100111111101101110011111101111111111101010110011111111101111011011110011010101001110101111011111111111101011001100111011101111101010010110111111101110110111111
1111111111111110101111101111110111111111001101110111111101100011100011111110111010111111110111110101101110001111101111011011111010011111101001001111111111011111
1011111101011111111111111111110111110111111111101001111111111111111111111001111111010111111111111010111111101110111110111110011011011111110001011101111111111110
1111000111111011111110111100011011111111111111111101101111111111011111110111101111111001111111110101111110110101111111011111111110111011111111111111110110111011
1111111111110111100111010111011111110010011111101111111100011111110111111111111111110111101111011011100111111010111111111101101111111110101111111111011111111111
1010100010111111011110110111111111111101111111111111111011011110111111111111111001011111111011111110111111111011011101101100111111111111111111111101010000100001
1101101000111111111110111011111111110101011111111111111110010111010111111100110110011011111100100111100111101001110111011111011111111111011000110110111011001111
1110111111111111111011101111110111111111111001101111110001111100111101111111111101110011011111111011111111111111011111011111111110111111111011111111111110110110
1010011101111111011101111111000111101110110111111010111110101011101111100001111011111011111111101111001111001100011111011000111110111110011110111011111110111111
0101101101110111101111001100111110111010111111111111111011010110111111111111111011011110111101111110100110111111110111011111110011111011101111111111111111101111
1111110110110101101111111111111101001011111110101110111111010010111111111100011111111110010110101101111111111100010110101111111111111111111111001111110011111111
0111110111001110101101010111110101011111111101011101011111111111110111101111111110110110111111011111111010111010011101011101111101011111101111001111111111010111
1111111101010111101111010011011101111110011111111011011111110110011101111111110110111111011111111101111111111111111111110111011111111111111010001111111111111011
1111111111110101111111101011111101111111111011111110111110111111110110111100001010111101110101011101101101001111011101111010010111011111000101011111111110011111
1101010001111011111101111101000111011110111111011011111111111111101111111111001111111110110011100010111111111111111111111110011111101111111111100111111101111101
aaaaaaaaaaaaaaaaaaaaaaaaaaaaaaaaaaaaaaaaaaaaaaaaaaaaaaaaaaaaaaaaaaaaaaaaaaaaaaaaaaaaaaaaaaaaaaaaaaaa110111111111111111110001110111111111100110101111101011111111
101111110100110111011110011110011111011111010110111011101111111111111011111111011101111111111100111a111111111111111111111101111111111101011001111110101111101111
111111110111110111011111111111111011011111111111001111101111111101101111111111111110011111111111111a111110001011010111110110100111101011111111111010111111110110
101110110111111011011111110111111111110011111101111111101111101111111111111111111111111111110011010a011011111111111110001011111111111101111111011011111011111100
111111101111111010111111110111000110111111111111101111101101101111011110101110111111111101101111111a11111111011111011011aaaaaaaaaaaaaaaaaaaaaaaaaaaaaaaaaaaaaaaa
110111110110111111111111110001111111111110101111111111110011011011111111101001100110110111111111110a00011111101110000111a111111111111110101111111011101111111011
111111111111010111111111110111111111111111110100110111111111111111111110111111111111111011110110111a11111010111111000111a011111111111110110011111110111111111111
111101110110111111111111111110111101111111110111111101111101101110101101111000001111011110111111111a11110110011101110010a101001111110111011110111111011011111111
111101101101111101111110111111101111111111111111111111001110111101111111111111101011110111111111101a11111110111111111111a110101001111111110101101111100111110110
110111011011001111011110110110111111111101111110011001111111101110111101111110011111111100111111110a11110011111111111110a111110011111111111111111111111101111111
111111110111101101110110011011111111011111111111111101111010111111111110011101011111111101011110011a10110111011111111111a111111101110111011110111111111010111101
110111010111010111111111110111111110110110111101111111011111101111111111011011010111110111111010101a01111111111111111111a001011111111111111100111111111111101111
111111011011111101111111101011111100011111001011011101111111111011011010111111111101111111100011110a11110101111110111111a100111001011011110111110111001110110111
111110010011111111001000001101111111101110111101111001111010111111111111110001111011111111111111110a11100011111111111111a111011111111101110011111111111010111111
111110100110111111101111111111111101001111110111111111111111111101101101111111011101011111111001111a11111111111110111100a111111111110111111110111101111111111111
101110011111111101111111011111110101101001001111111011111101011101111001101111111111100001111111111a00001010011111111110a110111110111111111010111111011010111011
111101111101111111111101000111111101111111110110111111111111010111011110011000101011111110110101111a11111111011111011100a111111101101111111011101011111111110010
aaaaaaaaaaaaaaaaaaaaaaaaaaaaaaaaaaaaaaaaaaaaaaaaaaaaaaaaaaaaaaaaaaaaaaaaaaaaaaaa1111010111111101011a01010011101111111111a000111011011101111111110111111110111111
1111101111111110111111110101110111111111110011111111011111001110111010111111111a1111111110111111110a11111111111111001101a111101111111101011100101101111010111111
1110110011110011111111011101011111001011111111111111001111011111110101111111111a1111111111011111010a11111111111111111110a010111111110111101011111111111111011111
1111110101011111101111101110111100111101111111111111010101111110111101111110101a1100010111110110011a11101111101101011011a111111101110111101001111101111111110101
1011000001101110111011111111110111111111101111101111011100111111101111011111111a1110111101111111011a11001011101001011101a101111111111101111111111001110101110111
1111111110111000110011110110110111101111110111111111110101111111111111111111111a1111111111111101011a11111111111110101100a111110001011111101111111011101111011001
1111111111000001100111111101111111101101111100011101001110011111101111111111111a1111101110111011011a11111111111101111011a110101111110111111111110111110101111110
2211201020002221111012011111111111111100111101110011111101101011111111110111111a1110111111111110111a11101100101111011111a111111111011111010111101101111110110110
0212120012210111112221220111111110111111111111111001101112010112112202202221212b1222021111010010111a11111111010111001111a111011111011111100111010101111111011111
0102211211121011221112212011100111100110111111101111001120010222221011100111212b0222111111100111011a11011111111111111110a110011111111111111101010111101101110111
2001210221212121211220112111111111101111011110101101110110122101102212101011211a2110222111111111100a11111010101011111111a111100101011111100101101100101010111101
1220101222222111121102221110111111111001111110111110101120202200120211110201102b2011121100111110111a11110111010101101110a111101110111111101111111011111011011111
0110010222110201122112222100111111111101111111111111011112221011020202120111111b1112022111101010101a11011110111111010110a101101110011111101011011110011111101110
2110202212111002101020221011111111001111101110101111110111122111100011210121221b2211111110111111111a11111100011110111111a110110101110111111111001111111111111111
2011022012121221111102102111011110110111111111101111110112211201221012112211212a2212220111111101101a01011010101111101101a100111011110011111011111111101110010101
2111211022212020100211021011111111110011110110111110111112221121220112210210220a2111222111111111110a11011111110111111000a111011011011111011110011011111111111111
2111212100210221021211220211111120221221110112101101111021122122011002120122210b0202210111110101101a11111111111101011111a111111111001110111101111111110111100111
1122001010101012211020212212112022222012121102101101111001102202121022221220101b1111201100111111111a11010111111110111110a111100110111101101111011111011101100101
0221212202212121111102222022111120222220112100221222111112111212000111022000101b2112102000111110111a11011111111101101001a110100111111111101111110111011111010111
2122211111221211200022111211212202111211221122211201111020020111211012020122112a2020021111001111110a11111111011111011111a101101111011011111011001111111111111101
babbababaaababbaabbbbabbbbaaabbabbbbaababaaababbaabbaaaabaaaaabaaabaabbabbaababb2211122111111111111a11011111011101101001a111111110010100010110101011110111101111
010111221200211111212222011111122111210101220222121011111210111100221011202211002120202221211202112b20022020111001101111a101011011100101111101111101111011011110
120111112221020212120212211021212212222121200000020111111202010211211020210122122221211022210011220b00202210210011111111a101111111001011111001111011111001111111
202022200022010210111022211201112010202201212212000211111101002212101222111222101220202101202021112abbbbaababaaaaaaaaaaaa101111111111111111100011111111011011111
01222022221222022221221202022212100222222101222112101110211211202212202111222222211222220122222021221202010211111111101aa011111001111111111101111111100101010011
bbabbabbbbbababbbbbbbbbbbaba2022122212112222222010121101111221222011112111110222022000111112100211201001221021011111000aa100111111111111111001011011110110110111
211220221222122222211222222a1121021102001011021011010101201111221112112211010210222021201112121121222121120011001111101aa101101101100110111111111001111110101111
022211220121122200220210021a2001012100220202212121220111222220121221221011211022200122011120112110012021202111100111101aa010000101010111101111111111111111101111
220110122222022202002221010a1011111202221112111210021111211110220002221222220120212212101221212100111112012111110110010aa100110010111111011011111111111110111111
122211211222022201011002121b1210121101201011221111011111212211112122012212222120200220221220022102202012201211111001111aa111011111110001111111111111010111111111
112100200022212011111222110b1122102212200210101212220111101222012201110222220222221121210220211011020002110221111111101aa111111011101111111011110111011101001111
020200122020112222222022122b2111011102012111111202201111121101212111211211121211222122101110110112222002200121110111111aa111111101111111011100011111111111111111
201021001221020122221212020b1220212221211212220122221111200021100120121120111121001220012220022112111202221021111100111aa101011111111010011011101111111111011111
002122202220221200120022220a2101121112021100121210110010112102001012101100210221220220100210111111121110220120101110111aa011111111110011110111101111011110111111
220220200112212221110220021a1200212011102101112012220111101211210002121202222020222020021121000102020021022221111111111aa110111111111010111111111000111111110011
112001222221011022101201211b2122221221212120221110021111220211221221101102211212222212111200022221002220112211010010111aa110111110111011111111111011011111101111
221222202122012201222212211a2111121112122121220110111011221011110212110101012122012022221020112221121022112021111101111aa101010111111101110011110100010111000101
221122112222022222102202201a2012120211011011221201011011122122211111220221121201200221222221220000121111122201101111011aa101110100122111201021212122202220110011
110010210212221210000122000b2220011222221221201111221011120112112211012202112210210201210102110212201111122211101101110aa111101010010011220010120222222211022210
210100010122112220001111122b1100220022201100001022021111011111101110111111111111221121121121002120111111212121101010111aa101011112000122211212110111121122122111
222111212111122221100221120b2222122122021221111101110110110111111101111111111111212002212022211110121122110221110111111aa011110111121012202220222121201212220221
202021111202212122111011221a1111122221122111012122210101100111110111101111111122112201211110110200021212012021111110111aa110111010112201222220202012101110101121
202221121020211012100122211b1121201111220122112112021111101010111111111111111121011222012100201201122022011020111101111aa111110101212121101111121121121121011222
210102111211022210111121112b2121020222222121121111111100101111011111011111111020022222020121021211110202121100111001011aa111011112101101222220212000112210112121
122211220121121222101121022a2001101020222021010120211101111101111111111111010101012120021011111012211111211101011111111aa110101110112122111102111022020001102010
112101020022011010010102212a1120011211112122101000111111111011110111011011011020020020121122111101122122100221111111100aa010101112120122011101021110120101202120
221000220222211121110202100b0112201221122222220201001111111011111101011101111111222201120110221220201212222121101111111aa111110112210202221011102112122210201122
020220102210221222110101111a1001111111011101011110111101110010101110111101111002202211012121110002222021021021111111111aa111110111210000221211212221121112122110
222012111012010221101111111a0111010111110111110110101111101110111111111111111121110121101122010012120111220220001111111aa111111112222211200202122012222102212101
011210201000211102111101011a1111001111111011111011101101011111111011011011101100110121002120102112212000120201111101111aa011101102020012021222011001011210202121
022122221212212222110011011a0101110011111101100101001110110001111001011101010102210120212121221020101022202210010011010aa101110111212201211022110021022211111211
120112102112122121111011101a1101110111011101011111101110111101111111111111110110221202220122112002012111221200011100111aa111000112121000021201200002110101021121
202102112021112022011111111a1111111111111111001110111111000111111110111111001010111111111101111111110111011111001101100aa110111112001201120222221011011220112222
212222021222222020111111111a0111111111101011011111110000111111111101010101011111111111111110011010101111110111101011111aa111010111122010122020222122120222100220
111011111001111111010111111a1111111000110100110111111111111111111111111001111101111011111001111101011101111111110111111aa110111111220222102120200122001211100001
101110111110011100111111010a1101011100111111101101111011111011111011101111011101111111010111011001011110111011111111001aa110110111220222011102112102122110212210
111110101111101111111111110a1001001111010100001110111111110101111011111100111111100111101110111101010011001111111111011aa011110112221020210010020021212200222221
111111010011111111111111111a0011111111111111110111111010000111011110101111011110111111010101011111101111110010111111111aa111010012110222012222202222222222220222
111110111110110101110111010a1110110111111111111111111110010111111011111111101111000111101111110111011111111111111111111aa101111111202112122202022210202010222121
101101111010111111111111111a1010111010111100111111111111100111101110111010101101011011011110101111001011100111111111111aa111101111221110120222212222022222001122
111101111111111111111110111a1101101111001111111001111101011001000111011111001011011111011011110111011011111001101011110aa111101111121022001111021222221120220212
110011111111101101011111111a1111111111110111111101111011011011112122212101121211211102102112021111111100111111111011110aa111001112200122211220220120222022212022
011110011001011110110011111a1111111011101110101111111100101111100221101220111212012121122020201011111101111111111110011aa111110111002201110122222222121122222222
111111011011111011111101111a1100011111111010111101101111111111001212211210211011121002200200021011111001100111111111011aa101110100012210122010222201202001122022
111110111011101111001011111a0110111011111100111111111110111111121122002212220202120120012111121011111111010010011100110aa010101011221012202222020120011212202221
111111101011111011111010011aaaaaaaaaaaaaaaaaaaaaaaaaaaaaaaaaaaababababbaababbbaabbbbaaaa2210121110111101111111110111101aa111101100101201122210212200021122222121
110111111101111111111110111111111111111001111100111101001100101112011121121210110221112b2210111101011111110111101111111aa111111102112212122122212202111112211201
011110111000111110101011111111111101111110111010111111011111111122111221221220112111010a1122010111110001110111111101011aaaaaaaaaaaaabbbbbbbbbbbbbbaababbabbbbbab
110111111111111111111100100001111111110111111111011111111111110212201112122001122121212b2101210001111111110110111111111a0010111111101011112210112221110011221211
110111111001111111111100111111110111101110011110101110101101101021111021212022022112210a2121211111110010110110011111111a1111110110111101102110111212212212102210
011101111111111111110111110110110111111011101110111111110111111221211222212212212201221b0202011111101011101111011011110a1100110101101101111220121111112211012110
101111111111111111110111111111101011110111011011111111111110111221121111111110121012122b1120111101011111111111110001111a0111111100001111111100211101210122102102
111111111110111110011111111011011111100101111111110101110111110112011112122110110001120b2112111111111101110111111111011a0111111110011111110121212020202122220011
101101110111011011101111111110010111111110101011111101111001111110110121111010112201211a1222221101111011111111111110110a1111111010111111112002212111022211111011
111101111111101111110010101110011110011101111011110111111111110212121200212210122021102a0111220110101111011111111011001a0011101111011111112222101110211220020010
001111111101110011111111111101111101101111111111010010101111111221201110211022011121120b0112211111111011111111111111110a1011001111011011110001222102001221201011
111110111010111111110110011111010011010111111001101111100011111222221022222122222122121a0222211110001111111011111111110a1011111111001111012112022211100212121202
110001110110011111011100101110100110111111111001111011111111110122202011122122222202001b1202121111101111110111110111010a1111011110101110112110221021122021211212
111111110111111011111111111110111111111011111111110101111111111200022101200012121002121a1121011111111010101110001111111a0111111111111111112220112110121112110211
101011011111101111110111111111011011111010111111111100110111111112221222120001212110121a0001121111101111111101110101011a1111011111111111111111000112211121012002
110111111111111101011111111111111101010111100011011111110101101100201220122122121020110b1011211111100101101011110101101a0111111111111111110120102120022111112021
110011111101111101111111110101111111111111111111101111110101101221122202201112101121212a2121220110101111111010101111111a1110111111111101111010102121012110011022
101011010101111111010111110111111010111111110100111011111011111211221120122112222021211a1212101111110101111101011111010a1111110111111111110120121112221100000122
111011101111111111001110111111111101101111111111110110110111011120101100121210210221212b1222111100011111011110111110110a1111111111111111111221201111021212020111
111100111011001101110111001101101111110001111111111110101011111121112011211221021212021b0101121111011111010111111110110a1011111111110101111120021202112112111122
