106 143
18 11
48 9
31 16
60 14
47 149
4 149
75 18
41 107
27 18
1111101101101a11111101101101110011111111111101101111111110111100111111000a10110111111110110101011111111111101101011011111111111111111110211101121201211202212221
0010111011111a10101111111111011101111011111111101101101010011111111001111a11110011111110001111110111111111000101111011111011011111111122101022210002002102021222
0110110001110a10110010101111011111011111101111110111111101101111101101100a10111110111111110110111111011111111101110101110101111011011112212111102102110222101111
0010110111111a01111011001110111110110110110111110111111111111110101111011a11111111111111111111101111111100110111100111011111111110101120212011000121222111222212
1111111111110a11011101110110011111111101011110100111010001111111111111110a11111110011011111111001111111110111111110011111111111011100122210221212112020222222202
0111011111001a10111111111111111011100010011110001011111110111111011111011a11111110111101010001110111111110011110111100010001101101111110120222102012111211011222
1101101101101a10111101111111111011110111011111111101010110101011011101110a11011111111011111001111111110111111110111100101010101101111112021112111101122212221112
1101011111101a10111110111101111111111111111101110101001111111011011111101a00111110100111111111001111111110110001101111111110111111111102121121002110020102111021
0111110011110a11111111101011011111100111010111110101111111111111011011101a01111110111101111111101111111011110111111111101111101111110110022221112222002122200112
0101111111101a10001110001110011010000101010110011101110111010010101100111a11111111110010110111111110111101011011110111111111011110111121200220011000222100212111
1110010111111a01111011111111011110111101111111110110110111010111111111111a11111011111111101001101011011101111111101111111011111101111012222002002021100202001221
1111111111001a11111111110101101111110111101111111110101111011110101101111a10010111101111111111111111111111110101111111111011110101101012221022001112111202012202
0001222022122b20011210002202010221110010111111111110111111011101101111101a10010111110001111001111111111110111101011110111011001101011021102220021120212220202101
1112112202222b12121111121122020002001111111110101011110111111111011111111a11111111111111111111011101111101111110110111011111111111111122122122112212221111122012
1101211021012a11102222122112010101110111101110101111111101110111111111111a11111111111111110011110011111111111011110110111111110111111121211212012102212001212210
0111020220122b01210222011221201001110010111111111111111100001110111111111a10111111011110111101111011001111011100111111111111111111110110112112210210212121101102
1002120221021b12021220221021221211011111010111111111111110111110011111111a10111101111111110111001011101101101001111101011111101111111112211211210000201110211111
1111220100222a22120222221202011212101111111000101101111110111111111101111a10101000101111111111111011101011011111111111011111101011101102022202212120112201022221
1210220102212b02220212222222222222111111101100010111111111111110111111010a11111011111011111111011111011111011111111111011000000111111102220022221122012001212202
1112220011211abbbabaabbbbbbbbbbaba1000010111110110011aaaaaaaaaaaaaaaaaaaaa11111111111111101111111010111101001101111111111111111111110121112101212012121202110121
002220012121021111222221222222220b0100111101110101111a0111011110110011000010111111111111111111011111101111111110111111111011110111011111110110101111011011111110
022111220111202020011210021220122b1110011110111111111a0111101111100101011011111111111101101010111111111111101111111010111101110101101011011100111011111111101111
120202101222202102022112222201222b0011111111101011101a1010111111111011101011111100011111010101101110110111111111101111100111111010111100110111111111011111110111
111222021202222111202220202122021a1111111110110111101a1111011101010111111110111101111111111011011111111010111111011111101111111111101111011111010111111111111011
110001222101201102222210202002221a1111111111110111111a1111111010111110011111111100001101111111111111010110111111011101011001011111011111110100111101000100110101
011212112221120222010022221222022a1111111111011110101a1110110111111110100100111111111111111111100111110111110011010011011011111111111010110011111101010111111111
111021122022221212121202120222012b1111110101111110111a0111111111111111011111110111111111011110222120210121212100010202111211111111111001101111111110111110111101
120221201220202122121221222222121a1111110111111111111a1111111010111011110011111111111101111011212011102211221210112201220221111011110001111101111110111111111111
121200220021000211221222110220202b1111011110111101111a1101011110111111111101111011111111111112111211011110222020120112101021110101111111111011011111111011111111
112122122222221222122222212020222b1110111011111110110a1111110111011100111111011101111110111121210110210122011021112112202111111100111111111101101110111111011111
102200202220212222020022201222120b1110111111110100001a0111110111101111110111111111111111011122112222110210210112200210210221111110101010101111111111110011111111
111211122121112220010120102210021a1111111101111111101a1111101111011111111101011111111010111112022222121202021221021110110221111111010111011100100111110101010110
021122022221212222022222012202221a1111110011011010001a1001101011110001101110111011111111111111202010021200002112121222122021010111011111122211211222120011010202
112222222222220012212020200012201b1111111111101111101a1101110010110111010101111011101100100102122122220121102011122110211111111111111121211112121211202021102021
222222020220120211022100021021221b0101111011111111101a0101111111011011010111100111111101111112201110101121221111110222022200111111101122011112011222201211211121
222222220222222022212222210012221a1011111101111011111a1111111111111111010111110111101001111111222012012000122202121112112020111010011011102212100102211222021012
120222022222202222221220202211202a1111011111111010111a1110111111111001001111110110011101110111011111222100222221122102022111111011110112110102210010211121121101
022220022020220022012121222021221b1011110111111111110a1011010001011110101110111101111011111000121011011120122021221201112210111100111002202202012110111021121101
122222200220222222220020211202121b0101111111001111111a1101111110110011100011111101011010111022212011212121202110202110220200111101110012201210210111020012121211
221222022220222222112022112202220aaaaaaaaaaaaaaaaaaaaa1111011111101011111111101111101110111010211212022022220111112122222021011101110101111100022110221020202121
abbbbbbabbbbbbbbbbbbbbbbbbbabbbbabaaaaaaaaaaaaaaaaaaaaaaaaaaaaaaaaaaaaaaaaaaaaaaaaaaaaaaaaaababbaaaabbabaaabaaababababaaabaaaaaaaaaaaaaaabbababbbbabbaabababaaab
2112002222222220211222022212212112111101111111111110100111101111111111101111111111111110111112122012201011111201120111221121101101101121111112112202221201220100
2212222210022022222200222122222012101010111111011010011011111111111110111110111101111111111001120102201211221212220211211011010111111120010112211021102112122212
2222222102222202222202202221122001011111111011011111100110101111111110111010111110110101110120201120121112212111122211000101110111011112201000212121120101201222
0121120012002211222210222122111210111101111111111011110101111111110111111111001100111001101112212210201111102112212111121210101101111121222021002221121111110121
0022200222222122222220220222021101110111111011101111010110110101101111111101111111110110011122000121221011012222000222222110111111111120200112120111122010121212
2202222222020201212202202022011101101011011010010111101111001000111111110111111111111110111021211011112121121221221200121211111101100101111211120112122220021012
1110221221212202211201222211211111001111111010101111111111001011100111101111011111111111111001122121111002202221221210222111011100101121212112012121210002122022
0202100220222022220222020212011111111111101101101111011111101101111011111101111111111011111022012121210111022222022222011211111110111122112221011201100121012111
2001112212202202220202222222111111111111010011010111101101110111111011111111111111011011111122112221102011212101201211211221111101111111011122222211020212012201
1221221222221121021022102201210111110011001100111110110111111111001011111111011001101110111110021101011101112102022111002020010100010122101022221102222111221121
2021222112222221002222222120121110111111011111101001111011110111101011111011111011111111011120210022122212120111121111002211111111011112102020121221111212020211
2220022002221222222221122112211110011111111011101111111111111110011111111111011110111111111112102120201202112111010212110211011111111122112102222012201111121111
0020212102011222220202222011211111011111111111101011011111011001000011101111111111011111111112121222101211200100212100002111111111010012121110212202210211202121
2221022101210022210122021201200110111011111111111101111111011011111111111111110011111011001110211022010222002111211112212011111011111121202220202221121010212222
2102122122222112112200222111221111111111101110111111100110111111111011111111001111011111111112112122112011211111112211111111111110111012202221112221222112012021
2222222202222222220222022102020011111111111110110110111010100011111011101100111101001011110111200112221122111102110110220021110111111101022201201212211121102220
2202122202220222202200002121221111111101100111110011011011011110111111101101111110011110111111111101111011100111001111011011111110111011212111200122011201000021
2002122222202220022222210101221111111110111110111110010111111110001101111110111001100011111111111101110111011111111110111111111011111122111120201221102111000011
2212210220022002220212200121211011101111111111111111111111010111111111111101110111010011111101111111111110111011011111101111110111111121101200200221222020222122
222022222222212222002222202020100111011111aaaaaaaaaaaaaaaaaaaaa1011101101110111111111101111110010010110111111001101111110111011111101101012120110111111121201201
220222222202222222222212221021221111111110a1001011111000110010a1111110011111110111111111001101111111011010111110110111111111111111011102020211122010211101210211
200220222221202022212202202220220211101110a0111110101101111001a1111111010111111101011110011111111011111111011011011100111111111101011120220121212112100221012120
001222222122122222222222010222221011101111a1110111110111111111a1111111011110110001111111111010110110011101101111111001111111111001110111111110110111110101111111
102120202222212221211101101022211011111111a1001011101101110010a0011100111011100111101010011101111111101001111101110110101111010101111110011111111101011111011011
111001001122220102012020220212122101101111a1111110111111111101a1011111111110111110111100111101011111111011010101111011011111111101110001110111111111110101111110
212022222101220222212222221222211111111101a1111111110110101110a0110111001111101110111110111111011101111101111110011011101101111000110101110110101111010110101101
021201212221021222122202122222120211111101a1101110100111111111a1111111111111110101011011111111101111110110111101111111111011111111110111111111111111111110111111
022212222022202212220222120200212011111001a1000111101111011111a1111011111101111110111111111110101100111101111010111111111110111101111111111111111100110011101111
212112022111022122220102201022222211111111a1111111101111111111a1110110111010111111011111111111111001001011110011100110111011111111111110101110110111111110100111
020022102010122222212212022211212201111111a0101111111111111111a1101011110110110111011111111101110111011011000111101000011111011101111111011011101000111111101101
201222112012212220202022002110102211111110a1110111111011111111a0011010111111110110011110110111111111011001111101111110111111111110111011111111101101111110101110
212222022212222020202022222222002101101100a1110101101110110111a1000111011110011101011110001111111111111111111111100101011110110111111111011111101111101110111111
102222000222222222221111222002221111111110a1111111111011111101a1111111111110111111100011011111110011011010101111101111111010111111111111111111100111111111101011
212112222212222202212020111222222111111110a1000111110111101111a0111110110111111111111001111100111111011010011111011001111111111111110111001111011111111001011110
202122222022211022002002212210110110111010a1011001111111111110a101100001111111111100111111111111111111111110111111011011aaaaaaaaaaaaaaaaaaaaaaaaaaaaaaaaaaaaaaaa
111110121211112202112112122101211201010011a0110011111111111111a111101111110111101010101110110111111111111011111110001001a011111111110110111111111111111111110111
101202110120222201210221120221211111110111a1011110010111000011a101101111101110111111101110111111011111111001111110011011a011111011110011110111111010111111111111
111102120221102222112210121221110211101111a1111111010111111010a111100101111111101011111100101111101011110101011001110111a011010010110110110111100111011011110111
111111200120210122122101120212111211111011a0111100101111111100a111101101111011101101101011111101111110101111111011001111a111111001101110111101111110111111111111
111022122201112001202210222122222211111101a0111011011111010111a110011100010011001111111011111111111111110101111111111011a111111011011111111101101011101111001111
111221211211222101221122111122012111110111a1001011101111111111a101111010000111111100111101110111111111101111111011011101a111111111001101011011111111011111111111
111210122112122222221212220212221111101111a1111011111101111111a111011110111101101111001111110110011011111111111111100101a110111111111111101111011100101101111111
011010012000121222111001110021021211101011a1111110111111110011a111111111011011111110111111111111111111011010110111110111a100111101101110101110111110111101100011
111122120211212112222011220012111210111111a1111101011111111111a111111111011100110111101110111110111111111101111111101111a111101111111110111101010111011101100101
111120110220121121101211211212001110001111a1111101011010100010a111011111111111110101111110110101111011011101010100110110a101111101111111011111111110111101111101
111211221121122000211110220022102211111110a1111111101110111111a101111111110111111010011011010110011011111111011111111111a111111111011111111110101111110010111001
111221021221111012112012221112111010101111a1100101111111111011a111111001111110011101111111111111111011011111111101110011a111111001011111110111111111111110111011
111110011222102201101120021211111211011101a0011111111110111101a111011111110100111011110111110111111110111011100110111101a011111011111111111011011011111111111111
011202121120010202022222020110222011111110a1111111111110001110a011010111110111101111101011111111111011110101110101101110a011101111101101111111001101110111111111
111121111221120102011202020012122101111111a0111111101111101011a111101111010011110111111001111111100101110110111111110100a101110111111010111011111011111011111111
111111011111011110111011101111001011111101a0010111100111111110a101111110011111101011100010011111111111111101001110111110a111110111101110111111111111111111111111
011110110110011111011011010011101101110111a1111111111001111111a110110110011100111011110111111101111111111010111110010111a000111001111111110110111111111111101011
110110100001001101111111101010110111101011a1010110110111110111a111111111111111111111100110110101101111110111111111111111a111111101111111001111111110111111111111
100111101111111000111111111111111111101011a1001011011111011101a011101110111111011111011111101110111101001111011111011101a011111011011111111111111111011110101111
111011111001101111111110111000111011111111a1111100101111101001a10111110111111100aaaaaaaaaaaaaaaaaaaaaaaaaaaaaaaaaaaaaaaaa111111000011011000111011111111111111101
111111101010111101111111111000111111110110a0110110011101111111a11111100111101101a0110111110011101011101111101110011111111111111111110111110111111111111111111011
111011110101011111111011010101111000111111a1111101101111100111a10011110111111010a0000011111110010111101111001111101101101101111101111110111111010011100111111111
111011111111110110110111111111100011111111a1011110111111101011a11111101111011111a1011011111110100100111110110101011111101111111110101111111101011011110110111111
111111111101001110111111110111110111011111a1110101111010111111a01001110101111101a1110100011111111100011110111101110111111110111011110110110110110111111011111111
111011101011111110111011011111111111011011a1101111111010011111a11111111010111111a1110111111101111011111111111111110011111111111111111111101111110101011111101101
110011011111011111101111111011101011001101a1111111111111110110a10011110010111111a1111011110001011111111111101111111110101111111010101111010111111111111110111111
111111011111110011111111110111111111110101a1111001011111110101a10111111111110111a1111011010111111111111101111111111101110111111111110111001111100111110110111111
111101011011111110111111010111011110111110a1000111111010111011a11000111111111110a0110100111101111111101111111111111111011011111101011111011111101111101111110111
110011110011111111111111111011101111100011a0101111111101111110a01101110001011111a1010101110101111101111101111111011111111011110110111111110111101011110011011010
111101100111101110111111111101111111111011a1011011100111111100a00110111111111111a1111110011111101111001111101111111100110111011111011001111111111101111111101111
100110111111100111100110000111111101111111a1011111111111111111a11111110100111011a1111101111111011101110111001111101101101111101111111111110111111001111111111010
011111111111101111111110111100011111011110a0111101011111111001a11110100111100111a1111010111010011111111111011011011111100111111101011011110011111111011110111111
111111111011100101110111111010101110101111a1111111110011111111a10011110111111111a1011111011111101111101111111101111111110101110111011101100011110100111101111101
110111011011111111111111111111001110110110a1111000011111011111a01111110110111111a0110100111111111111110111111111101011111011101111111111111101101111011010111111
111111111101011100110011101111111110111011a1110111111111111111a01100111111100111a1111111010011001110111111101101111110111111111101110101100111011101111110111111
111111100111111101111111011011110111001111a1111111111011111111a11111110111011111a1011011111111111101111111111110111111111111111101111110011110011101111111111110
101111111000101111111101111101111011111011a1111111011110101010a11110111010111110a0101101110110111111001111111111101110110111111111101010110111101110111001111111
111111101111111011111111110111111111111111a1111111101101110111a01111111111011111a1111111010111101111111100111111111011011111010011110011111111111111011111111011
100111111111110011111101111111101111111100a1111111110111101111a11011011111111111a1111010011111110111111001111110011011110101101111111111111111111111111111111010
011111110110110111100111011111110000111111a1011011111110111101a11101101110011111aaaaaaaaaaaaaaaaaaaaa11010110111111011001011111110011111111111111111111101110011
111011110010011101110111011111011111011110a1111111101111111111a1011010111011111111011111011110110101a11010011110111111100110111111111110101111110110101001101111
111111111111010111111110110101001111011101a0111111101110101011a1010111110111101011100111111111101111a11010100111100111111111111111011111110111111101111001011111
111011111101111111111011111111101101101111a1011110111111111011a1111111111011110111110111111111111101a11111110110110111111101101110011011001111111111111110110111
011110111111110111011101111011100111101111a1110101111001111111a1111011111011101100111111100111110101a11111111111111011101101111001101111010110111110111111001111
