104 9
1 6
117 96
84 27
103 155
46 147
62 10
15 31
43 88
13 156
1011101101010010222110110100121220111211021212211111101111111111011101111111011111111111100110111011111101101111010101111111111110111101111012220111111110021220
1111111111110011111112201222121101222101201010101111011001010100111111110011111101101111101111111111111111111111111111111111111101111101111011002110222211220222
1110101111111101111220210212011021222212012212000111111111101111011111110101000111001011111111111110111101111100111110011010101111111111111101011221200120212020
0111111111111111210212211212211221122220121110001111011111111010110111111101111110110111111110111110111111111111110111101111000111110111111111110202120212102112
1110110110110101120001222211122202122201100120010101111011111111010100100111111111111111100111111111111111111101111111111101111111110111011112201011220111022102
1111111011110111201121122122212021210112110102210011111111011010111111111111000110111111011100001101111111111111000101111111111011111101101110222120212211022210
1010111010101111022122122210110112101100112212210111110111101111111111110101011110101111110110111110001011111111111111011111011011111011011110120101120111101122
1111011111011010201120111200120111122210221222211011011111111100111111011011111100111101101011111111011101111111111111111100111011101111011111201101200221100110
1111111110101011002111202021102220221221022221211011111000111111111111111111110011111011101010101100110111111111111111011111110011110110011111111111222022101121
1001000111111010121021001112220121122000012201211111110110110111011101110111011101111111111111011111011111001111111111111111111101111011011111022101111212122212
1101011011111110212112212011221222221200202121011101110011111101111111111110011111001111111110111110110011110111111111101011110111110111111111121122121122112102
1011011111101101111212211221111200200110011121111110110111110011111111110111011111101110101110111111111011111111011111111100110000110111110101220222002211110022
1110110111111111210120111121110120111002112121111110111111101111110111110111111101111111110001111010111111011111111111111011000010001111011110120222110121112011
1011110110111101101202221211122110120221011212211111111101110100111101100011111111111110111111111101101110111000111111111111101111110111111002010000121112201202
1111101111111111121120022222110222112122110122201011111111111110111110111010101101110111100111011111111111111111111101011111001001111011111110121011222210002120
1111110110111111210112222121221122022220022111011011100111110011111111110111111111110111111110111111111101110111110111110110111111111111110111212222110210110120
1100111111111111220000110010110221112222211222011000111111111111111110000101001001101001100101111011111111111101111110111111111111011111111111212102112020202022
0111111111111111012120011121112221012221111210111001011010111110011111101010011011101111111111111111111011111111111111111101010000101111111111111122111002100002
1001101011101111121111101102122011111111221221211011011111101110101111111011011111111001101110110110000011111110010111101011011111101011111111221110212102222112
1110110011111111222121012122112000122101202112211111110111111010111111111111111111110110111111011011111111011110011101111101011110111100110011211221011212200222
1111111101110101102121122022121121222112121101210111011111011011111011011111111111110110111101011111100111111011011011001111111111111101101111120201222212111022
1111111111101101110111210221111120122221121210110111111111110111011110111111011101111111110011001110101100110010111011001101011111101101111111112222111220121222
1111111110101111012221121010102011012001122102211111101111101011111111110101111111111111011111111111011111010111111011111100011010110111101111120221211121202211
1111111111111111110202122211212211111121112110111111111110111111111011111111111111111011011011111111001101100111001110111110111100011111111111020210120112110212
1100111111111111111112021201012211222122112120011111011001011101110100011111111111011111111110110001001111111111111110111111011111101011111110111221121020111202
1111110111111101211011222102202212101220222200101100111101110111010101111011111110111011010110111111101101011101111111111111101110111101110011222211210112120102
1111101111111111220121010121200100210212111002111111011110111111111101111111111111111110100111111011110111111011111010111110111110111101111111011222222122111221
1100101111111110222022112022122110202202101122110011111111101111111100111100011111101100111101111111110111111111111011111111111011111111110111222021021202222111
1111010110011101202102120122211121100200001222111111111111011111110000111001210021122221021021120220101101111111111100011111111111110011100112111212122211112211
1110110011111111202210111121120201221121021101111101100110111111111101101212112022111211112220220121020211101010111010011111101110101111111111100101111110011011
0111111100111111102122211012022100220022112101001111111111110111101111111221022122120211212012121122102011110111101111011101110111011111111111111110101111111111
1111011110111101110111110101101111111111011101101101101111111000111111110012211121222121022112121010211200011010101011111111111111110022002212122021221011122201
1111011110111111010111011111111010000111101001101111011011111110100111111212222122101101121122121100122010000101111111111111110111111110200211121112120202222111
1111110111101110111001011111000111101110101011111110111111111111111111011010112212001100222202000220201111111111111011111111111011111102201220121212111102211110
1101110011111111011111111111111011111110011110111111011111110111001011011212111212121221122121212211211011101001001111111111110111111212212221120011220120211211
1111101101111111111111110111111011111111110011111111111100111100101111101112112102211121121212111112220011111101111111111101111111012011122122121112100211222102
1111111010011111111111111101101111111111110111111111111111111110101111110221122011210202210100110211002211011111010111101001111111111121121211112211022112111212
1111110011001001011111111100011111111111011111111111111101111111111110011212111211222220120100222011221011011111111111001111011101111221022201122121112202211111
1111111110111111111011101111111111101110111011011111111110111111111111110212221102122122112211110121021211110011101110101111111101101002120111201110102121220011
1011110111111111011100011110111111011110111110110101110111101011110100111020022022002211012222022102212210111111010110111011111111111112212012221002212012002012
1111111110110010011011010110011111111011111111110111111011111111110111110112022100112122211111222202101211111111101111111111111111100121012200121122011222222211
1111101111111111100111110111111011101001110111011111110111110101101101111201121110211111122012200001121110111111110111111011110111011111022011212120122222211221
1011101111111011111111111011111011111111111110111101010110011111100111101111201202112202122111112210122211011111111101111011010111111211011102122011111022222021
0101101010011111111110100110100111111110111111011111101110000111111110111112122110111211000011220100121210111111111111111111110111101100211221010111221211221111
1111011011111111111111101111111111111110111011111111011111111101111000111221120211102121100211211202110011111111101111010011111111111211021020222111210112012110
1110111111111111001111111011111101111111111011101111110111110001011010111112210121201211001221102111111110111010111110111100110111110011222201122122122112021211
1111011111011011111111111101111011111111101100111101101111111111011011111121122100112211021122222002211111111111011101111110110101112212121221212122212122121211
1222021020211212021112220201111111111011110011111111110111101100111001111121101111100111111222201110200111110111100011111111011101111101022022021001112221110211
0002021111110202211112220011111110101111111110111111001111111101110111111020201220100212011210112012221011111111101111110010111110012111002012102222022012010211
1112101122210020122022201010011111011101111111111100111011111101111110011202121100211010022210120211112111110110011110001111011110110101120221220122001212212212
2212100211011221221221000211101111111111111111111111111111111111010011111122122101110111110202021001222210111110001110111001101110112022211112021012220101122122
1221221210222220212221112111111011111100101011111111101111101111011110110000212211110220211020020122222110100010111100111111111110111201110122101122012100112110
1202220011222100211112112211111110001111111101110111101110110111111111111110112121201002102221120101121111110001011010101101010111012222121212111210220022111022
2222212002102010121122222011101110111101111111111111111111101101111111110211221012212011120021220021121211101101111111111111001101111111201221111100120212011002
2121011121111221200111122011110111111011111111111100111110010011011101110111111212111220200011222002000111111101101111011101100100011110221220201211212001001201
2111211010001211211122102210010101101110011110010111111110001101111111111200222122220222201121111122012111001111011011111111111110111210112221221120101200022201
2212200212210212222121221011111111111111110001001011101111111111111111111211222212210101012020122222212201011111110111110011111111111220201110121111222011211022
1201121122112211221111212200101111001111111101011111011111110111111101101021211201222212101221202110000201100110111110001011111111111122000112212200102021101122
0212121211211122111202121110011110101101011111111111111111011100111101111210122021112111122111022121022210111111110111011111111001110222120201220222210202122012
2122202112202121200210021111111011101111110111001000111111111111010111011110100111110111111110111100111111111101111111111100101010011112122112121202020121221010
1120122120111212122200102011011111110101111101110111111110001011011111111110110101111101111111110111111111111111111011101111111011110010212122021211122212001001
1121212221120112212221222110111111111011101101111101111111011111011111110110011111011110111101010010011111111111111110110111110110011112011111200022012111211112
0212121101221221100021222111111111111111100110111110111111011111011011111111101110101111111111111110111111111111011111011111111101111010111101111110111101110101
0222101102011210102210122111101111011010111111001111111101110100111111111110101101011011111001101011001111001111110101111111110111111101111111101011011110010111
2011222111101120202212021111110111011101111111111010011110111111111111111111111111011101010011110011111011011010111011111110111011110111110101011110111111111011
2102010101021011221112120011011111111111011111111110111111111111110011111111001101111110110011110011101111111011111101011110111011111111111111111011111111011101
2021210101020222122212121111111111110111111111010101111110011111111111110111111101111101110111100111101111011111111111111111110001011111100011011101010111111110
1000112111121122211112001211011111111110111111111010001010001001111111011011001110100011111111111111111111100101111111011101111111101110011100101011011111110111
2110121122212122112122122201111111111111110111111111011110101110111011011110111010111101111101111101000110101111111111101011011001110111010110111111111011101111
2212110011102211122122220101210221110011120111101111111111100011111000111101101111010111001011111111011011011111010111111111110101101111110101111111111101011101
2100012122222222122012220202011211021222010111110111011100111111011011111110011111100101011111111111111111101110111111011101111111011110011011111011110001111111
2222010110012221221200002211220121200111122111110101101111111111111111111111101111111101111110110111110111111111111111111100011111101101111100111111111111111100
2220102222211211101020021222112021111200122111111111110110011101110111010011111111111111111111011101101111111010111111011111111111110110001011011110101110111111
1012122100210022220000100022212121012112022100110110100111111111111111111111111111111111011111111111011011110011110111111101111001111111011111111111111111111111
2121100022122200222122201021120202110021000111110111101111101111111111111011111111011100101000111111111111111111011110110111111011100111101101111100011111111110
1111222110112022222202110122202012021121120111100111111111111111111001110111111011111011111101111011101110111110111110111111111110101111101111000001111111011110
1122002122222002201221022221221020201112200110111111111101111111111101111111111101111101101011011011101101101011111111110001110110110111101101111011111111011100
0220212200002120221222120001211120122201111111100111111111011111111110011101111101110110111111110111011101111111110010111111110111111111111100111110101001111011
1010111010012111122112202121112000102221212111111111111111111101111011101011111101110111111110011111111110110111011111111011100011101111101111011111111111111111
1111011101111021202122102022201122221110111110111101110010111111111111101111111111111110111011111011111111111111011101110111101101111001101111111011011101111111
1110110111111121202022010222210011212111111111111111111111101110001111111111011111111011110111101111111000110011101111100011111110110100111111111110111011111110
1101111111112201010011101210112010121211101101111111110011110111011111011111110101100111111111111011000101111111011101011110110110011111001010101111111111101010
0110110110110220200101110200120112121100012010110011111101011111111101010110111110011111100110111011011111111001111111110101111111111011111100111101101011111101
1111111111112111101221121021200101122212212110011101110001111100101100111110111110101110111111111111101111001111111111111110111110111111011111111111111011101101
1011111111101221120122122010200212001121122111111111011101111111010110101111111011101111011111111111010101111001001101111111101011111110110011110110110001001111
1111001111110012200122001110122120022202212111111001001011001100101001111101111011011111010111111111111111111111111111001110111111111111111011111111111011111111
1011101111110012110212020202002211002122222111101111110111111000101101110110111101111010001111111111100101111111010101111110111111010111111111111111101011101111
1111110111012121010102111201220222111201012001111111111011110111011111110111111011111111111111101111111100101011110111111011010110011111111111111111111111111111
1111101011112211212200121221121002102122111011101011111001111101111111111010100011110101110011111111101011111111111111110111111010011010011100011211111111110110
1111110111112001222102212011111110112222221111111111111100110111111101110111111111111111111000101001111111111111111110111110011111111111111000112121220122221221
1101111111101121112022112211101202222211101110111101100111011111111010111011111111110111010111111111101111001101111101111111110110111101111112201212021111211112
1011011111110211110222201220222222121001201111110111011110110110101111111111111100110001111011111111110111110110111011001111101111110001111011201120112110002221
1011101111112210122012201221211101121102100110101110011101111111111100010101111101111111111110111011110111110111011110111110110110111111110111021121221020111221
1100111010012110222222002111202110020122120111011011111111010101011101101011111111011111110111111111111111110100111111111111101011100101111102120122111010112001
0011111101112120212112221022210111221121112111011111011111001111011111111011011111110111111111111111111101111110111111110111011110111110101002121212010012212210
1001100100101200010011122220122011120111210101111111101100110111111110111110110111001110110110111111111111101101111111100011111111011001011021222021211121012221
1101111001110212111221102221102102121122101111111011011111111111111011111100111111111111111111100011111011111111110011111101111111111111111011121001212211221201
1100100111102220212011122110121211212122100011110111111111111111111001101011111011111110111101111011010111111110111111101101111101111101111111210022011000122000
1111111111111201121122211111122112121121012111100111111100111111111011111011111111111111100011111111111011111101111111001111111111111110111102111121122100022120
1111111011112012121221000111122001121220211011111100111001011110111111111111111111101011111101110111111101111111101101011111101011011111101122001210121121122020
1111010111001111111111110111101111111111111011011001101011111111100111111111111101111110011111011111111011011111110111101110111100011100101010020202212222212121
1111111111111010101111100101110111111111111111111101101111010111010111101110101011010111011011111110111101111111011111111111111011111101110121121221210122221112
1111101110111111111111011111101110001111110111110101100001101101111111101111111012111212102121022201202020221022111111011111111011011111111121202221220210002101
1010111011011111011110111110101101001111101111111111110110111101010101010011111110112121111202211221011202201011010111111111111111010110111021111222211212200111
1111111111110111111101111011111011100111100111111111111111111111011101111011111110202112022020101221210112112011101101011111111101001111010022202121202222122112
1111111110011110101111111111111111110111111111111001111111011011111110111111111112212110112112001121220221111102111101101011110001111111011122111201210120210212
0111111111011111101101111111111001101111111111111111011111011111110100101010110101000211120212112111201011121122111111000111110111100101111012002101201212122222
1111111111111111110100111110001101111011111110101011111111111101111011111111011112222120211211111100202110201221111110111101110101101111011121012020111221222221
1111111010111011111100011111111111101011111111101110110011111111111111111111011111201021011111110021001201211111011111101101101110110111010120110210211100210002
1111111011111111111111101100111010111110110111110111101111111111010111111011111112001012110102021120202020212112001111111111111011111010011122012212012222111222
1111101000111110111101110111101110111011101010101101111111111011101101111111111111110220020121012200021122221201111101111111111111111010100012211212121122112221
0111100111011101111011101001001111011011011111111111111110111111111011101111111101201112222121022000202021222102010111010010110101010111111112120100122121210220
0111100111011101111111011111111100111110111111011110111110111100110011101111111111110201121220121011112112002201011111111011111111111101101112220221211001022101
1110011011101111101110111111101100111111111111111001111110110101111111101101111012220122212011110121210012122212111100011111110011011111111100201012112121022210
0110011101011111111111101011011110111111111111110111100011111111111101110001111110020121201121022120120221101120111111111111110111011011101021210202102122010022
1110111110110111111101011111011100111011111101111011111111111111111101100011011111122212022121111111011222120222011111101111101111011111101122220211212211121121
1110111111111110011101110101110110100111111111101110011111011011010011111110111012120112112211211111112202221012111011111111011111111111111110212121122222212021
1111011101111110111101101011011011101111111111011110101111111101101111110111111112011122212110111121002211121201110011101101011111100111110101011102101112202222
1101110010111011110110110111111111111111100011110111111111110011111101001111011012111110222210212102022121122220011011010111111111111110110122111002011112001121
1111111111111110111111111111111110111111011101110011111111111111111101101111110102201002122201102202011112211222111111111101111011111101111001111111110111011111
